aba → aba
abb → abb
abe → abe
abi → abib, abie, abir, abit, babi, gabi, mabi, rabi, tabi, wabi
abl → abl
abo → abo
aca → acad, caca, paca
acc → acc
ace → ace
ach → ach
aci → acid, acis, caci
ack → ack
aco → acop, acor, maco, paco, saco, taco, waco
acr → acre
act → act
acu → acus, jacu, pacu
ada → ada
add → add
ade → ade
adi → adib, adin, adit, cadi, eadi, gadi, kadi, madi, qadi, sadi, wadi
ado → ado
adr → adry, sadr
aff → aff
aft → aft
aga → aga
age → age
agg → jagg
agi → agib, agin, agio, agit, hagi, magi, ragi, vagi, yagi
agn → cagn
ago → ago
agr → agr
ail → ail
ain → ain
air → air
ais → ais
ake → ake
aki → akia, akim, akin, faki, kaki, maki, raki, saki
ala → ala
alc → alc
ale → ale
ali → alia, alif, alii, alin, alit, alix, bali, dali, gali, kali, mali, pali, tali, vali, wali, yali
all → all
alm → alma, alme, alms, balm, calm, halm, malm, palm, salm
aln → aln
alo → alo
als → als
alt → alt
alu → alum, alur, balu
aly → aly
ama → ama
amb → amb
ame → ame
ami → ami
amm → amma, ammi, ammo, ammu, lamm
amo → amok, amor, amos, amoy, mamo
amp → amp
ana → ana
anc → anc
and → and
ane → ane
ang → anga, ango, bang, dang, fang, gang, hang, kang, lang, mang, pang, rang, sang, tang, uang, vang, wang, yang
ani → ani
ank → ankh, bank, cank, dank, hank, jank, lank, mank, pank, rank, sank, tank, wank, yank
ann → ann
ano → anoa, anon, fano, hano, mano, tano
ans → ans
ant → ant
apa → apa
ape → ape
aph → aph
api → apii, apio, apis, hapi
apo → apod, capo, gapo, mapo, sapo
app → app
apt → apt
ara → ara
arb → arb
arc → arc
ard → ardu, bard, card, dard, fard, gard, hard, lard, nard, pard, sard, ward, yard
are → are
arg → arg
ari → aria, arid, aril, bari, dari, kari, lari, mari, pari, sari, tari, vari
ark → ark
arl → arle, carl, earl, farl, harl, jarl, karl, marl, parl, warl, yarl
arm → arm
arn → arn
aro → aro
arp → carp, harp, jarp, tarp, warp, zarp
arr → arr
ars → ars
art → art
ary → ary
asc → asci, fasc, masc
ase → ase
ash → ash
asi → asia, dasi, lasi, nasi, pasi
asm → kasm
asp → asp
ass → ass
ast → ast
ata → ata
atc → batch, catch, datch, gatch, hatch, latch, match, natch, patch, ratch, watch
ate → ate
ath → bath, cath, eath, fath, hath, kath, lath, math, oath, path, rath, tath, wath
ati → ati
ato → atom, atop, dato, jato, nato, pato, rato
atr → atry, natr
att → att
atu → atua, natu, patu, tatu
aur → aura, daur, gaur, laur, naur, saur, taur, waur
aus → aus
aut → aute, auth, auto, daut, faut, gaut, haut, maut, naut, paut, saut, taut
ava → ava
ave → ave
avi → avid, avie, avis, favi, kavi, navi, ravi
axi → axil, axin, axis, maxi, taxi
bac → bac
bal → bal
ban → ban
bar → bar
bas → bas
bat → bat
bea → bea
bed → bed
bel → bel
ben → ben
ber → ber
bes → bes
bia → bias, obia
bic → bice, bick
bil → bile, bilk, bill, bilo
bin → bin
bio → bio
bit → bit
bla → blab, blad, blae, blah, blam, blan, blas, blat, blaw, blay
ble → able, blea, bleb, bled, blee, bleo, blet, bleu, blew
bli → blin, blip, blit, obli
blo → blo
bly → ably
boa → boa
bol → bol
bon → bon
boo → boo
bor → bor
bou → boud, bouk, boul, boun, bour, bout, bouw
bra → bra
bre → bred, bree, brei, bren, bret, brev, brew, brey
bri → abri, brid, brie, brig, brim, brin, brio, brit
bro → bro
bul → bul
bur → bur
bus → bus
but → but
cab → cab
cal → cal
cam → cam
can → can
cap → cap
car → car
cas → casa, case, cash, cask, cass, cast, ocas
cat → cat
cea → cease, lycea, ocean, picea, sceat
ced → aced, cede, cedi, iced
cel → cele, cell, celt
cen → cen
ceo → ceorl
cep → cep
cer → acer, cera, cere, cern, cero, cert
ces → aces, cess, cest, ices
cet → cete, ceti
cha → cha
che → che
chi → chi
chl → chloe, chlor
cho → cho
chr → chry, tchr
chu → chub, chud, chug, chum, chun, chut, ichu, tchu
chy → achy
cia → cia
cid → cid
cie → cie
cil → cill, scil
cin → cine
cio → cion
cip → cipo
cir → cir
cis → cis
cit → cit
cke → ackee, acker, ackey, decke, icker, ocker, wacke
cki → gucki, uckia, vicki
ckl → ickle
cks → backs, becks, bocks, bucks, cacks, cocks, decks, dicks, docks, ducks, facks, fecks, fucks, gecks, gucks, hacks, hecks, hicks, hocks, hucks, jacks, jocks, kecks, kicks, lacks, licks, locks, lucks, macks, micks, mocks, mucks, necks, nicks, nocks, oicks, packs, pecks, picks, pocks, pucks, racks, recks, ricks, rocks, rucks, sacks, sicks, socks, sucks, tacks, ticks, tucks, wacks, wicks, yacks, yocks, yucks
cla → clad, clag, clam, clan, clap, clar, clat, claw, clay
cle → acle, cled, clee, clef, cleg, clem, clep, clew
cli → cli
clo → clo
coa → coak, coal, coan, coat, coax
coc → coca, coch, cock, coco, coct
coe → coe
col → col
com → com
con → con
cop → cop
cor → cor
cos → cos
cot → cot
cou → coud, coue, coul, coup
cra → crab, crag, cram, cran, crap, craw, crax, cray
cre → cre
cri → crib, cric, crig, crim, crin, crip, cris, crit
cro → cro
cru → cru
cry → cry
cta → acta
cte → cte
cti → actin, cacti, ctimo, eucti, ictic, octic, recti
cto → cto
ctr → ctr
ctu → actu
cul → cul
cum → cum
cur → cur
cus → acus, cush, cusk, cusp, cuss, cust, ecus
cut → cut
cyt → scyt
dac → dace
dae → dae
dal → dal
dan → dan
dar → dar
dat → dat
ddl → addle, oddly
dea → dea
dec → dec
ded → deda, dedd, dedo
def → def
del → del
dem → dem
den → den
dep → dep
der → der
des → des
det → det
dge → edge
dia → dia
dic → dice, dich, dick, dict, idic, odic, udic
die → die
dif → dif
din → din
dio → dioc, diol, dion
dip → dip
dis → dis
dit → dit
div → div
dle → bdle, idle
dly → idly
dne → adnex
doc → doc
dol → dol
dom → dom
don → don
dor → dor
dos → dos
dow → dow
dra → drab, drad, drag, dram, drat, draw, dray
dre → dree, dreg, drek, drew, drey
dri → drib, drie, drip
dro → drof, droh, drop, drou, drow
duc → duc
dul → dulc, dull, dult, duly
eab → eably
eac → each
ead → ead
eae → areae, rheae, teaer, teaey, zoeae
eak → beak, feak, leak, meak, peak, reak, seak, teak, weak
eal → beal, deal, feal, geal, heal, leal, meal, neal, peal, real, seal, teal, veal, weal, zeal
eam → eam
ean → ean
ear → ear
eas → deas, ease, east, easy, keas, leas, meas, peas, seas, teas, yeas
eat → eat
ebo → eboe, ebon
ebr → zebra
eca → ceca, ecad, teca
ece → decem, feces, grece, meece, niece, piece, spece
ech → eche, echo, echt, hech, lech, mech, pech, sech, tech, yech
eci → oeci
eck → beck, deck, feck, geck, heck, keck, leck, meck, neck, peck, reck, seck, teck
eco → eco
ecr → ecru
ect → lect, rect, sect
ecu → ecu
eda → deda, edam, leda, peda, teda, veda
ede → bede, cede, edea, eden, hede, lede, mede, rede, wede, yede
edi → cedi, edit
edl → medle, redly
edn → edna, fedn
edo → edo
edu → educ
eed → deed, feed, geed, heed, jeed, leed, meed, need, peed, reed, seed, teed, weed, zeed
eel → eel
een → een
eep → beep, deep, heep, jeep, keep, leep, neep, peep, seep, veep, weep
eer → eer
ees → bees, cees, dees, fees, gees, jees, kees, lees, pees, rees, sees, tees, vees, wees, yees, zees
eet → beet, feet, geet, keet, leet, meet, neet, reet, teet, weet
efi → defi, efik
efu → befur, waefu
ega → egad, egal, pega, tega, vega, wega
ege → eger, lege
egi → egis
egr → egre, regr
ein → bein, gein, hein, mein, nein, pein, rein, vein, zein
eis → deis, feis, leis, reis, seis
ela → ela
ele → cele, dele, elec, elem, elev, fele, hele, kele, mele, pele, sele, tele
eli → eli
ell → ell
elo → elod, elon, velo
els → els
ely → bely, dely, eely, rely
ema → bema, nema, tema, xema
emb → kemb
eme → eme
emi → demi, emic, emil, emim, emir, emit, remi, semi, zemi
emo → demo, memo, nemo
emp → emp
ena → bena, enam, gena, lena, sena, vena
enc → enc
end → end
ene → bene, cene, dene, ened, enew, gene, lene, mene, nene, wene
eng → eng
eni → beni, enid, enif, yeni
enn → benn, kenn, renn
eno → beno, enol, enos, enow, keno, leno, meno, reno
ens → ens
ent → bent, cent, dent, entr, fent, gent, hent, kent, lent, ment, pent, rent, sent, tent, vent, went
enu → benu, genu, menu, renu, zenu
eol → eole, geol
eop → people, reopen, teopan
eou → keout, seoul
epa → epa
epe → cepe, depe, epee, tepe
eph → epha
epi → epi
epo → epop, epos, pepo
epr → depr, repr
ept → dept, kept, rept, sept, wept
equ → aequi, cequi, equal, eques, equid, equip, equiv, equus, sequa
era → era
erb → gerb, herb, kerb, serb, verb, yerb
erc → merc
erd → erd
ere → ere
erf → erf
erg → erg
eri → beri, eria, eric, erie, erik, erin, eris, neri, peri, qeri, seri, teri, veri, weri
erl → herl, jerl, kerl, merl
erm → berm, derm, erma, erme, germ, herm, jerm, perm, term
ern → ern
ero → aero, cero, dero, eros, hero, kero, mero, sero, zero
erp → herp, lerp, perp, terp
err → err
ers → ers
ert → bert, cert, erth, hert, jert, pert, sert, vert, wert
erv → derv, ferv, merv, perv, serv
erw → erwin, lerwa
ery → aery, eery, eryx, gery, hery, very
esc → esc
ese → ese
esh → mesh, nesh, resh
esi → desi
eso → esox, meso, peso, yeso
esp → esp
ess → ess
est → est
eta → eta
ete → bete, cete, eten, fete, hete, jete, lete, mete, nete, pete, rete, tete
eth → eth
eti → ceti, deti, neti, yeti
eto → eton, keto, leto, peto, veto
etr → petr
ets → bets, fets, gets, jets, lets, mets, nets, pets, rets, sets, vets, wets
ett → etta, lett, nett, sett, yett
eud → euda, feud, leud
eur → eure, euro
eva → eva
eve → eve
evi → devi, evil, hevi, levi, nevi
exa → exam, hexa
exc → exch, excl
exi → exit
exp → exp
ext → ext
fac → fac
fer → fer
ffe → buffe, effet, gaffe, offed, offer, raffe, ruffe
ffi → affix, buffi, effie, offic, riffi
fic → fica, fice, fico, fict
fie → fie
fil → fil
fin → fin
fis → fisc, fise, fish, fisk, fist
fla → flab, flag, flak, flam, flan, flap, flat, flav, flaw, flax, flay
fle → flea, fled, flee, flem, flet, flew, flex, fley
flo → flo
flu → flu
fol → fol
for → for
fra → fra
fre → fred, free, fren, freq, fret, frey
fri → frib, frig, frim, fris, frit, friz
fro → fro
ful → fula, fulk, full
gal → gal
gam → gam
gan → gan
gar → gar
gas → gas
gat → gat
ged → ged
gel → gel
gen → gen
geo → geo
ger → ger
ges → ges
gge → agger, bagge, egged, egger, gigge, legge, ligge, pogge
ght → aught, bight, bught, dight, eight, eyght, fight, hight, light, might, naght, night, ought, owght, pight, right, sight, tight, wight
gia → angia, giant, hagia, kogia, logia, orgia, regia, vigia
gic → algic, logic, magic, orgic, yogic
gie → gie
gin → gin
gis → gis
git → git
gla → agla, glad, glam, glar
gle → gled, glee, gleg, glen, glew, gley, ogle
gli → glia, glib, glim, glis, ugli
glo → glob, glod, glom, glop, glor, glos, glow, gloy
gly → agly, glyc, glyn, ugly
gna → gnar, gnat, gnaw
gne → gneu
gon → gon
gra → gra
gre → gre
gri → grid, grig, grim, grin, grip, gris, grit
gro → gro
gua → agua, guam, guan, guao, guar
gue → gue
gui → guib, guid
gul → gul
hab → hab
hae → hae
hag → hag
hal → hal
ham → ham
han → han
har → bhar, char, harb, hard, hare, hark, harl, harm, harn, harp, harr, hart, harv, khar, phar, thar, whar
has → has
hat → hat
hea → head, heaf, heal, heap, hear, heat, rhea, shea, thea
hed → hed
hee → hee
hel → hel
hem → hem
hen → hen
heo → heo
her → her
hes → hes
het → het
hia → hia
hic → hic
hie → hie
hil → bhil, chil, hila, hile, hili, hill, hilt, phil
hin → hin
hio → ohio, thio
hip → hip
hir → hir
his → his
hit → hit
hlo → chloe, chlor, phlox
hob → hob
hol → hol
hom → hom
hon → hon
hoo → hoo
hop → hop
hor → hor
hos → hose, hosp, hoss, host, mhos, phos, rhos, thos
hot → hot
hou → chou, hour, hout, shou, thou
hra → aphra, ihram, mahra, shrab, shraf, shrag, shram, shrap, thram, thrap, thraw, thrax
hri → shri
hro → thro
hth → ichth
hum → hum
hyd → hyd
hyl → hyla, hyle, hyli
hyp → hyp
hys → phys, whys
hyt → hyte
iab → biabo, piaba
iac → diact, eniac, guiac, iliac, isiac, kiack, triac, umiac
ial → dial, pial, rial, sial, vial
ian → ian
iar → fiar, iare, liar, tiar
ias → aias, bias, dias, lias, mias, nias, pias, vias
iat → fiat
ibe → gibe, ibex, jibe, kibe, ribe, vibe
ibi → bibi, ibid, ibis, jibi
ibl → bibl
ibr → libr
ica → fica, mica, pica, vica
ice → ice
ich → ich
ici → nici, pici
ick → bick, dick, hick, icky, kick, lick, mick, nick, pick, rick, sick, tick, vick, wick
ico → fico, icod, icon, mico, pico
icr → micra, micro, picra, picry
ics → pics, sics, tics
ict → dict, fict, pict
icu → ficus, picul, picus, ticul, vicua, vicus
ida → ida
ide → ide
idi → bidi, idic, midi, nidi, sidi, tidi
ido → ido
ied → died, fied, gied, hied, lied, pied, tied, vied, wied
ien → bien, gien, lien, mien, pien, tien
ier → bier, dier, kier, lier, pier, rier, sier, tier, vier
ies → dies, gies, hies, lies, nies, pies, ries, ties, vies
ife → ife
iff → iff
ifi → rifi
ifo → fifo, lifo
ify → deify, edify, reify, saify, unify
iga → biga, giga, igad, riga, viga
ige → lige, tige
igh → eigh, high, nigh, sigh, yigh
igi → gigi
ign → ign
ike → ike
ila → ila
ile → ile
ili → fili, hili, ilia, pili, vili
ill → ill
ilo → bilo, dilo, filo, gilo, ilot, kilo, milo, silo
ily → ilya, lily, oily, pily, uily, wily
ima → ima
imb → imbe, imbu, limb, nimb, zimb
ime → dime, imer, lime, mime, oime, rime, sime, time, wime
imi → imi
imm → immi, immy
imo → limo, timo
imp → imp
ina → jina, kina, lina, mina, nina, pina, sina, tina, vina, xina
inc → inc
ind → ind
ine → aine, bine, cine, dine, fine, hine, inez, kine, line, mine, nine, pine, rine, sine, tine, vine, wine
inf → inf
ing → ing
ini → bini, fini, inia, init, mini
ink → ink
inn → inn
ino → ino
ins → ins
int → int
inu → ainu
inv → inv
iol → biol, diol, siol, viol
ion → ion
iop → biopic, biopsy, ethiop, triops
ios → ios
iot → fiot, iota, riot
iou → iou
ipa → lipa, nipa, pipa, ripa, zipa
ipe → hipe, kipe, pipe, ripe, sipe, tipe, wipe, xipe, yipe
iph → iph
ipl → ipl
ipp → cippi, dippy, gippo, gippy, hippa, hippi, hippo, hippy, kippy, lippy, nippy, pippy, sippy, tippy, zippy
ira → ira
irc → circ
ire → ire
iri → biri, irid, iris, jiri, kiri, miri
iro → giro, hiro, irok, iron, miro, piro, tiro
irr → birr, girr, pirr, tirr, wirr, yirr
isa → disa, lisa, pisa, visa
isc → disc, fisc, misc
ise → ise
ish → ish
isi → isis, nisi, sisi
ism → ism
iso → iso
isp → disp, lisp, risp, wisp
iss → diss, hiss, kiss, liss, miss, piss, riss, siss, viss, wiss
ist → ist
ita → ita
ite → bite, cite, dite, gite, itea, itel, item, iten, iter, kite, lite, mite, rite, site, tite, vite, wite, yite
ith → aith, gith, kith, lith, pith, sith, with
iti → biti, jiti, liti, siti, titi, viti, ziti
ito → ito
itr → jitro, litra, litre, mitra, mitre, nitre, nitro, titre, vitra, vitro, vitry
itt → bitt, ditt, mitt
itu → litu, mitu, situ
ity → city, itys, mity, pity
ium → sium
iva → iva
ive → ive
ivi → divi, ivin
iza → izar, liza, tiza
ize → bize, cize, mize, pize, size
izi → izing, kizil, vizir, zizia, zizit
ked → ked
ken → ken
ker → ker
ket → ket
kin → kin
kle → ankle, dekle, ickle, inkle, kleig, pikle
lab → lab
lac → lac
lad → lad
lae → alae, blae, laen, laet, slae
lag → lag
lai → lai
lam → lam
lan → lan
lap → lap
lar → lar
las → las
lat → lat
lau → laud, laun, laur, laus
lde → aldea, alden, alder, elder, olden, older, tilde
lea → lea
lec → alec, elec, lech, leck, lect
led → led
leg → leg
lem → alem, clem, elem, flem, leme, ylem
len → len
leo → leo
lep → lep
ler → ler
les → les
let → let
leu → leu
lia → alia, elia, glia, ilia, liar, lias
lib → lib
lic → flic, lice, lich, lick
lid → lid
lie → lie
lif → lif
lig → lig
lik → like, slik
lim → lim
lin → lin
lio → clio, lion, olio
lip → lip
lis → lis
lit → lit
liz → liz
lla → ella, olla, ulla
lle → alle, elle, ller, lleu, llew
lli → allie, allis, balli, belli, calli, celli, dilli, galli, ollie, palli, pulli, selli, talli, villi, willi
llo → allo
llu → ayllu, illus, lludd, pallu
lly → ally, illy, llyn
lne → elne
lob → lob
loc → loc
log → log
loi → loin, loir, lois
lom → glom, klom, loma
lon → clon, elon, flon, lond, lone, long, lonk, slon
loo → loo
lop → lop
lor → lor
los → clos, glos, lose, losh, loss, lost
lot → lot
lou → lou
low → low
lph → alpha, delph, dolph, gulph, ralph, sylph
lte → alter, halte, velte, volte
lti → altin, balti, bolti, culti, multi, volti
lum → lum
lus → flus, lush, lusk, lust, plus, ulus
lut → lut
lve → elve
lys → lys
mac → mac
mag → mag
mak → make, maki, mako, maku
mal → mal
man → man
mar → mar
mas → mas
mat → mat
mba → amba
mbe → ambe, imbe
mbi → ambit, iambi, kumbi, limbi, mbira, nimbi, zimbi, zombi
mbl → amble, umble
mbo → ambo, umbo
mbr → ambry, ombre, umbra, umbre
med → med
mel → mel
men → men
mer → mer
mes → mes
met → met
mia → mia
mic → amic, emic, mica, mice, mick, mico
mid → mid
mie → amie, miek, mien
mil → mil
min → min
mis → mis
mit → mit
mma → amma, emma
mme → ammer, comme, damme, emmer, emmet, emmew, femme, gimme, homme, immew, lumme, momme, pomme, zimme
mmi → ammi, immi
mmo → ammo
mod → mod
mol → mol
mon → mon
mor → mor
mos → mos
mot → mot
mou → mou
mpa → campa, impar, pampa, pompa, tampa, vimpa, yampa
mpe → amper, campe, empeo, imped, impel, impen, imper, tempe, umped
mph → mph
mpl → ample, amply, imply
mpo → campo, compo, impot, tempo
mpr → mpret
mul → mule, mulk, mull, mulm, mult
mun → mun
mus → mus
nab → nab
nac → nace, nach
nad → nad
nag → nag
nal → anal, nale, unal
nam → nam
nan → nan
nap → nap
nar → nar
nas → anas, nasa, nash, nasi, naso, nast
nat → nat
nca → inca, onca, unca
nce → once, pnce
nch → inch
nci → unci
ncl → encl, incl
nco → nco
ncr → incr
nct → unct
ncu → encup, incur, incus, incut, uncus, uncut
ncy → ency
nda → anda
nde → ande, ende, inde, unde
ndi → andi
ndl → bandle, bindle, bundle, candle, dandle, dindle, dirndl, fondle, fondly, handle, hendly, jondla, kindle, kindly, mindly, mundle, pandle, pendle, randle, rindle, rondle, rundle, sendle, sindle, tandle, wandle, windle
ndo → undo
ndr → andre, indra, indri, undry
nds → ands, ends
ndu → bundu, endue, fondu, hindu, induc, indue, indus, lendu, nandu, rendu, undub, undue, undug
nea → nea
nec → neck
ned → ned
nel → nell
nem → mnem, nema, nemo
nen → nene
neo → neo
ner → nerd, nere, neri, oner
nes → anes, nese, nesh, ness, nest, ones
net → net
neu → gneu, neuk, neum, neut
nex → next
nfe → infer, unfed, unfew
nfi → enfin, infin, infit, infix, unfit, unfix
nfo → info
nga → anga, inga, ngai
nge → angel, anger, bange, binge, conge, dinge, engem, funge, gange, gunge, hange, henge, hinge, ingem, inger, linge, longe, lunge, mange, minge, munge, pinge, range, ringe, singe, tinge, unget, venge
ngi → angia, angie, engin, fungi, langi, lungi, mangi, pangi, pungi, sengi, tangi, tingi
ngl → engl
ngo → ango
ngr → engr
ngs → engs
ngu → angus, fingu, jingu, kingu, kongu, sangu, tengu, ungum
nia → inia, nias
nic → nice, nici, nick
nid → nid
nie → nies, unie
nif → enif, nife, niff
nim → nim
nin → nina, nine, ning
nio → niog, unio
nis → nis
nit → nit
niz → nizy
nke → ankee, anker, danke, inked, inken, inker, inket, onker, unked, unken, unket, unkey, zinke
nli → anlia, canli, conli, danli, funli, ranli, unlid, unlie, unlit
nme → enmew, inmew, unmet, unmew
nna → anna
nne → anne, inne
nni → anni
noc → nock
nog → nog
noi → noil, noir, noix
nol → nol
nom → nom
non → non
nop → knop, nope, snop
nor → nor
nos → nos
not → not
nou → nou
npr → unpray, unprim, unprop
nre → anre
nsa → ansa
nsc → mensch
nse → ense, nsec
nsh → bensh, unshy
nsi → ansi
nso → canso, insol, manso, senso, tenso, unson
nsp → insp
nst → inst
nsu → ansu
nta → anta, inta, unta
nte → ante
nth → nth
nti → anti
ntl → intl
nto → into, onto, unto
ntr → entr, intr
nts → ants
ntu → antu
nve → convex, convey, denver, enveil, invect, inveil, invein, invent, invert, invest, unveil, unvest, unvext
oar → oar
oat → oat
oba → oba
obi → obi
obl → obl
oca → oca
occ → bocca, bocce, bocci, cocci, cocco, hocco, occas, occur, yocco, zocco
oce → boce, soce, voce
och → och
oci → foci, loci
ock → ock
oco → coco, loco, moco, poco, soco, toco
ocr → ocrea
oct → oct
ocu → jocu
ocy → ocyte
oda → oda
ode → ode
odi → modi, nodi, odic, odin
odo → bodo, codo, dodo, iodo, jodo, modo, odor
off → off
oga → boga, hoga, ogam, soga, toga, yoga
oge → doge, foge, loge, ogee
ogi → yogi
ogr → ogre
ogy → bogy, dogy, fogy, logy, pogy
oid → boid, moid, ooid, roid, void, zoid
oin → coin, foin, hoin, join, loin, oink, oint, roin
ois → bois, gois, lois, pois
oke → oke
ola → ola
old → old
ole → ole
oli → aoli, coli, doli, goli, holi, koli, loli, olid, olio, soli
oll → boll, coll, doll, foll, goll, holl, joll, loll, moll, noll, olla, poll, roll, toll, zoll
olo → bolo, golo, kolo, lolo, nolo, olof, olor, polo, solo
olu → tolu
oly → coly, holy, moly, poly
oma → boma, coma, goma, loma, noma, oman, omao, omar, soma, toma
omb → bomb, comb, tomb, womb
ome → come, dome, gome, home, kome, mome, nome, omen, omer, pome, rome, some, tome
omi → bomi, komi, momi, omit
omm → comm
omo → homo, momo, pomo
omp → comp, pomp, romp, womp
omy → domy, homy
ona → ona
onc → conc, onca, once
ond → bond, cond, fond, gond, hond, lond, ondy, pond, rond, sond, yond
one → one
onf → conf
ong → bong, cong, dong, gong, hong, jong, kong, long, mong, nong, pong, rong, song, tong, wong
oni → oni
onn → conn, donn, tonn
ono → ono
onp → nonpar, pronpl
onr → conrad, conred, conrey, konrad, monroe, nonrun, onrush, sonrai
ons → ons
ont → ont
onv → conv
ony → ony
ood → bood, food, good, hood, lood, mood, pood, rood, wood
oof → oof
ook → book, cook, dook, gook, hook, jook, kook, look, nook, pook, rook, sook, took, yook
ool → bool, cool, dool, fool, gool, hool, mool, pool, rool, sool, tool, wool, zool
oon → boon, coon, doon, goon, hoon, joon, loon, moon, noon, oons, oont, poon, roon, soon, toon, woon, zoon
oot → oot
opa → opa
ope → ope
oph → koph, moph, qoph, soph, toph
opi → hopi, kopi, topi
opl → mopla
opo → topo
opp → opp
ops → ops
opt → opt
ora → ora
orc → orc
ord → ord
ore → ore
org → org
ori → bori, dori, kori, lori, nori, orig, rori, sori, tori, zori
ork → cork, fork, nork, pork, work, york
orm → corm, dorm, form, norm, worm
orn → born, corn, dorn, horn, lorn, morn, norn, orna, porn, sorn, torn, worn
oro → boro, loro, moro, toro
orp → corp, dorp
orr → corr, dorr, orra, porr, torr
ors → ors
ort → ort
ory → ory
osa → dosa, osar, rosa, xosa
osc → osc
ose → ose
osi → osi
oso → koso, soso
osp → hosp
oss → boss, coss, doss, foss, goss, hoss, joss, koss, loss, moss, ossa, osse, poss, ross, soss, toss
ost → cost, dost, host, lost, most, post, tost, wost
ota → bota, iota, jota, kota, lota, mota, nota, rota, vota
ote → bote, cote, dote, gote, hote, lote, mote, note, pote, rote, tote, vote, wote, yote
oth → both, coth, doth, goth, loth, moth, soth
oti → boti, hoti, otic, otis, poti, roti
oto → oto
otr → botry, gotra, notre, piotr
ott → bott, cott, mott, otto, pott
oty → doty, toty
oug → doug, joug, ough, toug
oun → boun, foun, loun, moun, noun, roun
our → our
ous → nous, oust, rous, sous, yous
out → out
ove → bove, cove, dove, gove, hove, jove, love, move, oven, over, ovey, rove, wove
ovi → ovid, ovis
owe → owe
own → own
oxi → oxid, oxim
oxy → oxy
pac → pac
pal → pal
pan → pan
par → par
pas → pas
pat → pat
pea → pea
pec → opec, pech, peck, spec
ped → ped
pel → pele, pelf, pell, pelt, pelu
pen → pen
per → per
pet → pet
pha → epha, phar, phat
phe → phew
phi → phi
pho → pho
phr → phr
phy → phys
pic → pic
pid → ipid
pie → pie
pil → pil
pin → pin
pir → pir
pis → pis
pit → pit
pla → plak, plan, plap, plat, play, upla
ple → plea, pleb, pled, plew, plex
pli → pli
plo → plod, plop, plot, plow, ploy
plu → plu
pod → pod
pol → pol
pon → pon
pop → pop
por → por
pos → pos
pot → pot
pou → pouf, pour, pout
ppe → appel, appet, eppes, kappe, nappe, rappe, upped, upper
ppi → ppi
pra → prad, pram, prao, prat, prau, pray
pre → pre
pri → pria, prie, prig, prim, prin, prio, priv, prix
pro → pro
pse → apse, ipse, psec
psi → psi
psy → opsy, upsy
pte → pte
pti → optic, septi, uptie
pto → aptote, captor, ceptor, crypto, egipto, emptor, haptor, laptop, lepton, ptoses, ptosis, ptotic, raptor, tiptoe, tiptop, uptore, uptorn, uptoss, uptown
pul → pul
pur → pur
pyr → pyr
qua → qua
que → que
qui → qui
rab → rab
rac → race, rach, rack, racy, srac, trac
rad → rad
rag → rag
rai → raia, raid, raif, rail, rain, rais
ral → eral, kral, oral, rale, ralf, rall, rals, ural
ram → ram
ran → ran
rap → rap
rar → arar, rara, rare
ras → ras
rat → rat
rav → grav, rave, ravi, trav
rba → arba
rbi → erbia, harbi, irbis, karbi, orbic, orbit, urbic
rbo → arbor, carbo, garbo, gerbo, turbo
rce → arced, arces, circe, farce, force, garce, gorce, merce, terce
rch → arch, drch, orch
rci → cerci, darci, farci, marci, merci, orcin
rco → arco
rcu → arcus
rde → urde
rdi → mardi, pardi, verdi
rds → urds
rea → rea
reb → reb
rec → rec
red → red
ree → ree
ref → ref
reg → reg
reh → reh
rei → rei
rel → rel
rem → rem
ren → ren
reo → freon, ireos, reoil, reown, vireo
rep → rep
rer → erer
res → res
ret → ret
rev → rev
rew → rew
rga → argal, argan, argas, burga, carga, ergal, jirga, marga, morga, murga, orgal, organ, purga, terga, virga, yerga
rge → rgen, urge
rgi → argid, argil, argin, corgi, orgia, orgic, vergi
rhe → rhe
ria → ria
rib → rib
ric → ric
rid → rid
rie → rie
rif → rife, riff, rifi, rift
rig → rig
ril → aril, rile, rill, vril
rim → rim
rin → rin
rio → rio
rip → rip
ris → cris, eris, fris, gris, iris, kris, rise, risk, risp, riss, rist, sris
rit → rit
riu → arius, prius
riv → riv
riz → friz
rle → rle
rli → carli, marli, parli
rma → erma, irma
rme → erme
rmi → armil, armit, ermit, fermi, hermi, kurmi, murmi, tarmi
rmo → armor, hermo, jarmo, mormo, sermo
rna → arna, krna, orna, urna
rne → arne, erne
rni → arni
roa → proa, road, roak, roam, roan, roar
rob → rob
roc → roc
rod → rod
rof → drof, prof
rog → rog
roi → roi
rol → role, rolf, roll, urol
rom → rom
ron → ron
roo → roo
rop → crop, drop, prop, rope, ropp, ropy, trop
ros → ros
rot → rot
rou → drou, roub, roud, roue, roun, roup, rous, rout, roux
rov → prov, rove
row → row
rph → morph, murph
rpo → sarpo
rra → orra
rre → arret, barre, erred, harre, irred, irreg, murre, purre, tarre, terre, verre
rrh → arrha, myrrh
rri → arri
rro → arrow, arroz, burro, erron, error, morro, orrow, zorro
rsa → ursa
rse → arse, erse
rsh → ersh
rsi → arsis, dorsi, farsi, marsi, parsi, sarsi, tarsi, torsi, ursid
rso → arson, corso, orson, torso, urson, verso
rst → erst
rta → aorta, artal, artar, corta, kurta, porta, serta, torta, yurta
rte → rte
rth → erth, orth
rti → rti
ruc → eruc, ruck
rum → rum
run → run
rus → rus
rve → arvel, carve, corve, curve, derve, herve, kerve, kirve, larve, nerve, orvet, parve, serve, tarve, tirve, torve, varve, verve, warve
rvi → ervil, irvin
sab → sab
sac → sac
sal → sal
san → san
sar → sar
sat → sat
sca → esca, scab, scad, scag, scam, scan, scap, scar, scat, scaw
sce → misce, sceat, scelp, scena, scend, scene, scent
sch → sch
sci → sci
sco → scob, scog, scop, scot, scow
scr → scr
scu → scud, scug, scum, scun, scup, scur, scut, scuz
sea → sea
sec → sec
sed → sed
sel → sel
sem → sem
sen → sen
sep → sep
ser → ser
ses → eses, oses, sess, uses
set → set
seu → iseum, pseud, seugh
sha → sha
she → she
shi → shi
sho → sho
sia → sia
sib → sib
sic → sic
sid → sid
sig → sig
sil → sil
sim → sim
sin → sin
sio → siol, sion
sis → sis
sit → sit
siv → siva
ski → ski
sla → sla
sli → slid, slik, slim, slip, slit
sly → sly
sma → sma
smi → smit
smo → smog
sne → esne, sneb, sned, snee, snew
soc → soc
sol → sol
som → soma, some
son → son
sop → sop
sor → asor, sora, sorb, sord, sore, sori, sorn, sort, sory
spa → spa
spe → spec, sped, spet, spew, spex
sph → sphex
spi → spic, spif, spig, spik, spin, spit, spiv
spl → spl
spo → spor, spot
spr → spry
squ → risqu, squab, squad, squam, squat, squaw, squeg, squet, squib, squid, squin, squit, squiz, usque
ssa → ossa
sse → asse, esse, osse, ssed
ssi → ssi
sso → assoc, assot, basso, bisso, cusso, gesso, kusso, lasso, mosso, passo, ssort, susso, yesso
sta → sta
ste → steg, stem, sten, step, ster, stet, stew, stey
sth → esth, isth
sti → stib, stid, stim, stir
sto → stoa, stob, stod, stof, stog, stop, stor, stot, stow
str → str
sts → basts, bests, busts, casts, cists, costs, cysts, dusts, easts, fasts, fists, gasts, gests, gists, gusts, hests, hists, hosts, jests, justs, kists, lasts, lists, lusts, masts, mists, mosts, musts, nests, oasts, ousts, pasts, pests, posts, rests, rusts, tests, vasts, vests, wasts, wests, wists, xysts, zests
stu → stu
sty → sty
sub → sub
sul → sula, suld, sulk, sull, sulu
sup → sup
sur → sur
syc → syce
syn → syn
tab → tab
tac → tace, tach, tack, taco, tact
tag → tag
tai → tai
tal → tal
tam → tam
tan → tan
tap → tap
tar → tar
tas → tas
tat → tat
tch → tch
tea → tea
tec → tec
ted → ted
tee → tee
tel → tel
tem → tem
ten → ten
ter → ter
tes → ates, tess, test
tet → stet, tete, teth
tha → tha
the → the
thi → thig, thin, thio, thir, this
tho → tho
thr → thro, thru
thy → thy
tia → tiam, tiao, tiar
tib → tib
tic → tic
tid → tid
tie → tie
tif → tiff, tift
tig → tig
til → til
tim → tim
tin → tin
tio → tiou
tip → tip
tis → tis
tit → tit
tiv → tivy
tiz → tiza
tle → atle
tli → atli
tly → aptly, artly, fatly, fitly, hotly, oftly, outly, patly, tutly, wetly
tne → bitnet, catnep, etnean, ftnerr, jitney, setnet, witney
toc → toch, tock, toco
tog → tog
toi → toi
tol → tol
tom → tom
ton → ton
top → top
tor → tor
tos → tos
tot → tot
tou → tou
tra → tra
tre → stre, tree, tref, trek, tres, tret, trey
tri → tri
tro → trod, trog, tron, trop, trot, trow, troy
tru → trub, true, trug, trun
try → try
tta → atta, etta
tte → atte
tti → attic, attid, catti, gutti, hatti, matti, petti, potti, putti, ratti, tutti
tto → otto
tua → tua
tul → tula, tule, tulu
tum → tum
tur → tur
tyl → butyl, cetyl, ketyl, octyl, rutyl, style, styli, stylo, tyler, tylus
typ → typ
ual → bual, dual, qual
uar → guar, kuar, quar
uat → buat, quat
ube → aube, bube, cube, jube, lube, rube, tube
ubi → ubi
ubs → bubs, cubs, dubs, fubs, hubs, nubs, pubs, rubs, subs, tubs
uch → much, ouch, such, yuch
uci → duci, fuci, suci
uck → buck, cuck, duck, fuck, guck, huck, juck, luck, muck, puck, ruck, suck, tuck, yuck
uct → duct
ude → bude, dude, gude, jude, nude, rude, sude
udi → udi
udo → udo
uen → ruen
uff → buff, cuff, duff, fuff, guff, huff, luff, muff, puff, ruff, suff, tuff, wuff
ugh → ugh
uin → quin, ruin
uis → luis, quis, tuis
uit → uit
ula → ula
ule → ule
uli → kuli, puli
ull → ull
ulo → gulo
ulp → culp, gulp, pulp
ult → ult
uma → duma, huma, numa, puma, yuma
umb → dumb, numb, rumb, umbo
ume → ume
umi → gumi, sumi
ump → ump
ums → bums, gums, hums, lums, mums, rums, sums
una → una
unb → unb
unc → unc
und → bund, cund, fund, hund, mund, tund, unde, undo, undy
une → aune, dune, june, lune, rune, sune, tune
unf → unfar, unfed, unfew, unfit, unfix, unfur
ung → ung
unh → hunh
uni → uni
unl → unl
unm → unmad, unman, unmet, unmew, unmix
unn → unn
unp → unp
unr → nunry, unram, unray, unred, unrid, unrig, unrip, unrow, unrra, unrun
uns → uns
unt → aunt, bunt, cunt, dunt, funt, hunt, junt, lunt, munt, punt, runt, sunt, unta, unto, untz
upe → dupe, jupe, lupe, nupe, supe
ura → ura
ure → ure
urg → burg, lurg, surg, urge
uri → uri
urn → urn
uro → uro
urr → burr, curr, durr, gurr, hurr, murr, purr, turr
urs → urs
use → use
ush → ush
usi → susi
usl → gusla, gusle
usn → usnea, usnic, usnin
uss → buss, cuss, fuss, guss, huss, muss, puss, russ, suss, ussr, wuss
ust → ust
uta → uta
ute → ute
uth → auth, muth, ruth, tuth
uti → uti
uto → auto, suto
uts → uts
utt → butt, gutt, mutt, putt
val → val
van → van
var → var
vat → vat
ved → veda
vel → vel
ven → even, oven, vena, vend, vent, veny
ver → ver
ves → aves, eves, vese, vesp, vest
via → via
vic → vic
vil → vil
vin → vin
vis → vis
vit → vita, vite, viti
vol → vol
war → war
way → way
wee → wee
wel → weld, welf, weli, welk, well, wels, welt
wer → wer
whi → whid, whig, whim, whin, whip, whir, whit, whiz
win → win
wis → wis
woo → woo
wor → word, wore, work, worm, worn, wort
xtr → extra
yan → yan
ych → lych, wych
ydr → hydra, hydro
yin → yin
yla → hyla, pyla, xyla
yle → gyle, hyle, kyle, wyle, ylem
yli → hyli
yll → syll
ylo → kylo, xylo
ymp → tymp
ype → gype, hype, rype, type, wype
yph → syph
ypo → hypo, typo
yri → gyri
yro → gyro, pyro, tyro
ysi → lysin, lysis, mysid, mysis, sysin
yst → cyst, myst, syst, xyst
yth → byth, myth
yto → tyto
zat → zat
zed → zed
zer → zer
zes → zest
zin → zinc, zing, zink
