# This is the longest word for every syllable possible. Syllables with no solve are omitted.

aaa: aaa
aab: intraabdominal
aac: isaac
aad: staatsraad
aae: baaed
aaf: molengraaffite
aag: laagering
aah: baahling
aai: kamaainas
aak: steaakhouse
aal: rijksdaalder
aam: paraaminobenzoic
aan: canaanitess
aap: schaapsteker
aar: intraarterially
aas: meshuggaas
aat: kaataplectic
aau: paauw
aaw: paawkier
aaz: kalaazar
aba: semicabalistically
abb: historicocabbalistical
abc: crabcatcher
abd: abdominohysterectomy
abe: nonalphabetically
abf: abfarads
abg: crabgrass
abh: unabhorrently
abi: glossolabiopharyngeal
abj: nonabjuration
abk: abkhasian
abl: antidisestablishmentarianism
abm: abmodalities
abn: nonimpressionabness
abo: hyperdiabolicalness
abp: stabproof
abr: tetrabromofluorescein
abs: nonabsolutistically
abt: abterminal
abu: antitintinnabularian
abv: abvolts
abw: crabweed
aby: labyrinthibranchiate
abz: sabzi
aca: macracanthrorhynchiasis
acb: bacbakiri
acc: heteropolysaccharide
acd: macduff
ace: acetylphenylhydrazine
acf: macflecknoe
ach: hexachlorocyclohexane
aci: brachiofaciolingual
ack: disacknowledgements
acl: miraclemongering
acm: acmaesthesia
acn: anthracnosis
aco: pharmacoendocrinology
acp: tacpoint
acq: nonacquaintanceship
acr: macracanthrorhynchiasis
acs: hypochondriacs
act: aerobacteriologically
acu: hypermiraculousness
acw: detacwable
acx: acxoyatl
acy: demethylchlortetracycline
ada: ancistrocladaceous
adb: threadbareness
adc: radiobroadcasters
add: addleheadedness
ade: adenylpyrophosphate
adf: oversteadfastness
adg: gradgrindian
adh: antistadholderian
adi: dicyclopentadienyliron
adj: nonadjudicatively
adk: diadkokinesia
adl: figureheadless
adm: nonadministratively
adn: superdreadnought
ado: ultradolichocephalic
adp: adpromission
adq: subheadquarters
adr: adrenocorticosteroid
ads: adsignification
adt: stadtholdership
adu: unadulteratedness
adv: predisadvantageously
adw: roadworthiness
ady: magnetoplasmadynamics
adz: gadzooks
aea: pleuroperitonaeal
aeb: blaeberries
aec: appendicocaecostomy
aed: tessarescaedecahedron
aee: palaeethnological
aef: lachrymaeform
aeg: aegithognathism
aeh: literaehumaniores
aei: chlorophaeite
aek: daekon
ael: voltaelectrometric
aem: cyanomethaemoglobin
aen: ultraenthusiastic
aeo: zoologicoarchaeologist
aep: chamaepericlymenum
aeq: extraequilibrium
aer: aerobacteriologically
aes: pseudoaesthetically
aet: chaetophoraceous
aeu: parthenopaeus
aev: antimediaevalism
aew: spaewright
aex: ultraexpeditious
aey: willugbaeya
aez: praezygapophysis
afa: ultrafashionable
afb: leafbird
afc: leafcup
afd: tarafdar
afe: ultrafederalist
aff: pseudoaffectionately
afg: afghanistan
afh: leafhoppers
afi: nonultrafilterable
afk: kafkaesque
afl: polytetrafluoroethylene
afm: deafmuteness
afn: semideafness
afo: intraformational
afr: superultrafrostified
afs: cloverleafs
aft: handicraftsmanship
afu: metafulminuric
afw: afwillite
afy: tealeafy
afz: afzelia
aga: calcaneoastragaloid
agb: swagbellied
agc: agcy
agd: magdalenian
age: counterdisengagement
agf: stagflation
agg: counterexaggeration
agh: aghorapanthi
agi: membranocartilaginous
agk: agkistrodon
agl: agammaglobulinemia
agm: subdiaphragmatically
agn: magnetothermoelectricity
ago: bronchoesophagoscopy
agp: bagpudding
agr: nondiagrammatically
ags: tundagslatta
agt: agtbasic
agu: cephalothoracopagus
agv: sagvandite
agw: zigzagways
agy: theanthropophagy
aha: extrahazardous
ahb: zermahbub
ahc: wahcondas
ahd: mahdiship
ahe: tessarescaedecahedron
ahf: mustahfiz
ahg: uncompahgrite
ahh: wahhabi
ahi: suprahistorical
ahj: mahjonggs
ahk: kitkehahki
ahl: kjeldahlization
ahm: brahmanaspati
ahn: hahnemannian
aho: ultrahonorable
ahp: wahpekute
ahr: ahrendahronon
ahs: aliyahaliyahs
aht: drahthaar
ahu: suprahumanity
ahv: jahvistic
ahw: yahwistic
ahy: hexahydroxycyclohexane
ahz: shahzadah
aia: amidoguaiacol
aib: claibornian
aic: overthwartarchaic
aid: tetrakaidecahedron
aie: faussebraie
aif: copaifera
aig: unstraightforwardness
aih: palaihnihan
aii: shanghaiing
aij: azerbaijanese
aik: transbaikalian
ail: snailfishessnailflower
aim: irreclaimableness
ain: nonascertainableness
aio: tetraiodophenolphthalein
aip: cantraips
aiq: caiquejee
air: multimillionaires
ais: counterreconnaissance
ait: nontraitorousness
aiu: agelaius
aiv: oxycopaivic
aiw: porokaiwhiria
aix: caixinha
aiy: bhaiyachara
aiz: algebraization
aja: huantajayite
ajb: rajbansi
aje: majesticalness
ajh: ajhar
aji: thingumajigger
ajj: hajjes
ajl: majlis
ajm: jajman
ajn: yajnavalkya
ajo: majoritarianism
ajp: rajpoot
ajr: maharajrana
ajs: svarajs
aju: extrajudicially
aka: tetrakaidecahedron
akb: weakbrained
akc: cakchikel
akd: breakdowns
ake: shakespeareanism
akf: breakfastless
akg: peakgoose
akh: weakheartedness
aki: dyakisdodecahedron
akk: ishshakku
akl: speaklessly
akm: cloakmaking
akn: overweakness
ako: agathokakological
akp: breakpoints
akr: hypermakroskelic
aks: czechoslovaks
akt: breakthroughes
aku: rathnakumar
akv: akvavits
akw: breakweather
aky: shakyamuni
akz: achakzai
ala: palaeodendrologically
alb: gastroalbuminorrhea
alc: dihdroxycholecalciferol
ald: formaldehydesulphoxylate
ale: tetraiodophenolphthalein
alf: chloralformamide
alg: electroamalgamation
alh: benzalhydrazine
ali: pseudointernationalistic
alj: copaljocote
alk: alkylbenzenesulfonates
all: electroencephalographically
alm: ophthalmoblennorrhea
aln: hyperintellectualness
alo: electroencephalographically
alp: benzalphenylhydrazone
alq: catafalques
alr: superchivalrousness
als: pseudointellectuals
alt: aquopentamminecobaltic
alu: alumohydrocalcite
alv: electrogalvanization
alw: cathedralwise
alx: calxes
aly: nonpsychoanalytically
alz: schmalziest
ama: electroamalgamation
amb: pseudoambidextrously
amc: triamcinolone
amd: ramdohrite
ame: pseudolamellibranchiata
amf: demichamfron
amg: damgalnunna
amh: amherstite
ami: cyclotrimethylenetrinitramine
amj: clamjamphrie
amk: damkjernite
aml: dreamlessness
amm: aquopentamminecobaltic
amn: myrothamnaceous
amo: ophthalmodynamometer
amp: amphitheatrically
amr: steamrollering
ams: electroencephalograms
amt: steamtightness
amu: pratiyasamutpada
amv: ramverse
amw: bantamweights
amy: chlamydobacteriaceous
amz: lamziekte
ana: gastroenteroanastomosis
anb: llanberisslate
anc: pancreaticoduodenostomy
and: mandibulosuspensorial
ane: dichlorodiphenyltrichloroethane
anf: anfractuousness
ang: cineangiocardiographic
anh: manganhedenbergite
ani: antidisestablishmentarianism
anj: clanjamphrey
ank: superthankfulness
anl: ungentlemanlikeness
anm: cyanmethemoglobin
ann: noncannibalistically
ano: mechanotheraputically
anp: panphenomenalism
anq: tranquillization
anr: charlatanries
ans: transubstantiationalist
ant: antidisestablishmentarianism
anu: lymphogranulomatosis
anv: noncanvassing
anw: tradesmanwise
anx: overanxiousness
any: palaeoethnobotany
anz: extravaganzas
aob: ultraobstinate
aoc: subcontraoctave
aod: tetraodontidae
aoe: supraoesophageal
aof: ultraofficious
aog: chaogenous
aoh: pharaohs
aoi: aporrhaoid
aok: karaoke
aol: kaolinisation
aom: naometry
aon: pharaonical
aoo: yaoort
aop: ultraoptimistic
aor: extraordinariness
aos: intraosseous
aot: semichaotically
aou: ultraoutrageous
aov: intraovarian
aow: miaowing
aox: dopaoxidase
aoy: taoyin
aoz: aglaozonia
apa: laparocolpohysterotomy
apb: clapboarding
apc: hapchance
apd: slapdasheries
ape: psychotherapeutically
apf: chapfallenly
aph: electroencephalographically
api: anticapitalistically
apj: apjohnite
apk: unnapkined
apl: basicytoparaplastin
apm: chapmanship
apn: tetrapneumonian
apo: pseudoapologetically
app: appendorontgenography
apr: contraprogressist
aps: microencapsulation
apt: superadaptableness
apu: electrotheraputically
apw: pratapwant
apx: apx
apy: cardiotrophotherapy
aqa: qaimaqam
aqi: iraqian
aql: taqlid
aqo: yaqona
aqq: zaqqum
aqs: umiaqs
aqu: aquopentamminecobaltic
ara: thyroparathyroidectomize
arb: acetylmethylcarbinol
arc: zoologicoarchaeologist
ard: electrocardiographically
are: tessarescaedecahedron
arf: overfearfulness
arg: overargumentativeness
arh: clearheadedness
ari: antidisestablishmentarianism
arj: tearjerkers
ark: markgenossenschaft
arl: antiparliamentarians
arm: chemicopharmaceutical
arn: noncarnivorousness
aro: blepharosphincterectomy
arp: metacarpophalangeal
arq: contramarque
arr: nonmarriageableness
ars: diphenylaminechlorarsine
art: membranocartilaginous
aru: elaeosaccharum
arv: supermarvelousness
arw: dearworthiness
arx: procatarxis
ary: glossolabiopharyngeal
arz: bilharziasis
asa: nonpurchasability
asb: christmasberry
asc: nonascertainableness
asd: electrogasdynamics
ase: acetylcholinesterase
asf: fierasferidae
asg: pelasgikon
ash: nonfashionableness
asi: macracanthrorhynchiasis
asj: masjids
ask: taskmastership
asl: gaslightness
asm: magnetoplasmadynamics
asn: biasnesses
aso: epididymovasostomy
asp: bronchoaspergillosis
asq: quasquicentennial
asr: minasragrite
ass: counterclassifications
ast: gastroenteroanastomosis
asu: archtreasurership
asv: aasvogels
asw: caswellite
asy: pseudoasymmetrically
asz: kuvaszok
ata: pseudolamellibranchiata
atb: boatbuilding
atc: scratchification
atd: privatdocent
ate: formaldehydesulphoxylate
atf: flatfootedness
atg: wheatgrower
ath: pathologicopsychological
ati: pseudointernationalistic
atj: katjepiering
atk: boatkeeper
atl: transatlantically
atm: nonatmospherically
atn: overgreatness
ato: regeneratoryregeneratress
atp: threatproof
atr: regeneratoryregeneratress
ats: clemclemalats
att: counterattractively
atu: antisupernaturalistic
atv: latvians
atw: bumboatwoman
aty: platydolichocephalous
atz: ballhausplatz
aua: rousseauan
aub: daubentoniidae
auc: semibureaucratically
aud: caudatolenticular
aue: schopenhauereanism
auf: chauffeurship
aug: draughtswomanship
auh: suckauhock
aui: rousseauistic
auj: beaujolais
auk: winnipesaukee
aul: electrohydraulically
aum: autothaumaturgist
aun: isokeraunographic
aup: depauperization
auq: vauquelinite
aur: zygomaticoauricularis
aus: australopithecinae
aut: nonautobiographically
auu: weltanschauungen
auv: chauvinistically
auw: grauwacke
aux: bradyauxetically
auy: hauynophyre
auz: burkundauze
ava: cubicontravariant
avc: stokavci
avd: havdalahs
ave: hemidemisemiquaver
avg: avgasses
avi: antigravitationally
avl: manavlins
avn: ispravnik
avo: counteravouchment
avr: mavrodaphne
avs: shtokavski
avu: lithophotogravure
avv: savvying
avy: heavyheartedness
awa: catawamptiously
awb: strawberrylike
awc: kawchodinne
awd: bawdyhouses
awe: clapperclawer
awf: handsawfishes
awg: drawglove
awh: balmawhapple
awi: withdrawingness
awk: joukerypawkery
awl: nightcrawlers
awm: withdrawment
awn: pawnbrokerage
awo: unseaworthiness
awp: drawplate
awq: cawquaw
awr: nonoutlawries
aws: dawsoniaceous
awt: crawthumper
awu: awunctive
aww: strawwalker
awy: unlawyerlike
awz: lawzy
axa: nontaxableness
axb: waxberries
axc: waxchandlery
axd: flaxdrop
axe: cephalothoraxes
axf: waxflower
axg: taxgathering
axh: axhammered
axi: maxillopremaxillary
axk: kitkahaxki
axl: taxlessness
axm: axmanship
axn: overlaxness
axo: chemotaxonomically
axp: hoaxproof
axs: flaxseeds
axt: baxterianism
axu: cephalotaxus
axw: waxworking
axy: anthraxylon
aya: undecayableness
ayb: claybrained
ayc: playcraftsman
ayd: daydreamlike
aye: unprayerfulness
ayf: playfellowship
ayg: playgrounds
ayh: mayhemming
ayi: antirailwayist
ayk: shaykh
ayl: waylaidlessness
aym: holidaymaking
ayn: yesterdayness
ayo: bayonetting
ayp: sundayproof
ayr: playreader
ays: catercornerways
ayt: harpwaytuning
ayu: picayunishness
ayv: jayvees
ayw: photoplaywright
ayy: payyetan
ayz: wayzgoose
aza: nonhazardousness
azd: yazdegerdian
aze: chlordiazepoxide
azf: topazfels
azg: akazgine
azh: mazhabi
azi: dinitrophenylhydrazine
azl: azlactone
azm: khwarazmian
azn: ghaznevid
azo: succinylsulphathiazole
azp: gazpachos
azr: azrael
azs: vammazsa
azt: azthionium
azu: azurmalachite
azy: azygobranchiata
azz: belshazzaresque
baa: baalitical
bab: superimprobableness
bac: aerobacteriologically
bad: subadministratively
bae: amphisbaenidae
baf: subaffluently
bag: cabbageheadedness
bah: autobahnen
bai: bumbailiffship
baj: bajarigar
bak: bakersfield
bal: aquopentamminecobaltic
bam: phenylthiocarbamide
ban: sulphocarbanilide
bao: carabaos
bap: subapprobativeness
baq: subaquatic
bar: barothermohygrograph
bas: protobasidiomycetous
bat: bathyhyperesthesia
bau: subautomatically
bav: subaveragely
baw: bawdyhouses
bax: baxterianism
bay: bayonetting
baz: acetylcarbazole
bba: historicocabbalistical
bbe: flabbergastation
bbi: undershrubbiness
bbl: hobbledehoyishness
bbm: ebbman
bbo: tuberculatogibbous
bbr: subbrachycephalic
bbs: gibbsites
bbu: kibbutznik
bby: hobbyhorsically
bca: subcarboniferous
bcd: ebcdic
bce: subcerebellar
bcf: bcf
bch: subchronically
bci: subcivilizations
bcl: subclassifications
bco: nonsubconsciousness
bcr: subcreativeness
bcu: subcutaneousness
bcy: subcylindrical
bda: paralambdacismus
bde: bdellostomatidae
bdf: bdft
bdi: subdiaphragmatically
bdl: bdle
bdo: abdominohysterectomy
bdr: subdrainage
bds: bds
bdt: obdt
bdu: unsubduableness
bdw: subdwarf
bea: beautifications
beb: beblubbered
bec: pterygotrabecular
bed: uncircumscribedness
bee: beetleheadedness
bef: beforehandedness
beg: unbeginningness
beh: behavioristically
bei: plebeianisation
bej: bejewelling
bek: beknottedness
bel: superbelievableness
bem: antiparabemata
ben: alkylbenzenesulfonates
beo: hebeosteotomy
bep: overbepatched
beq: subequilateral
ber: scrofulotuberculous
bes: diethylstilbestrol
bet: nonalphabetically
beu: beuniformed
bev: underbevelling
bew: unbewilderingly
bex: subextensibleness
bey: barbeyaceae
bez: nonembezzlement
bfa: subfastigiated
bfe: subfestiveness
bfi: cherubfishes
bfl: subflexuously
bfo: subformativeness
bfr: subfractionally
bfu: subfunctionally
bga: subgallate
bge: subgelatinization
bgi: subgiant
bgl: subglobularity
bgo: subgovernorship
bgr: subgranularity
bgu: subgular
bgw: subgwely
bgy: subgyrus
bha: subhatcheries
bhd: bhd
bhe: subhemispherically
bhg: dubhgall
bhi: subhirsuteness
bho: subhorizontalness
bhp: bhp
bhr: apabhramsa
bhu: bhutatathata
bhy: subhypotheses
bia: dermatopathophobia
bib: biblicopsychological
bic: hyperpolysyllabically
bid: pseudoambidextrously
bie: circumambiencies
bif: dissyllabification
big: disambiguations
bih: mushabbihite
bii: manganostibiite
bij: bijectively
bik: bikhaconitine
bil: intertransformability
bim: phenylcarbimide
bin: acetylmethylcarbinol
bio: bioelectrogenetically
bip: bipinnatipartite
biq: nonubiquitousness
bir: birectangular
bis: bishydroxycoumarin
bit: pylethrombophlebitis
biu: paleoytterbium
biv: herbivorousness
biw: biweeklies
bix: bixaceous
biy: meshrabiyeh
biz: dissyllabizing
bja: subjacently
bje: subjectivoidealistic
bji: subjicible
bjo: frabjously
bjr: objranging
bjs: objscan
bju: nonsubjugation
bka: abkari
bkb: bkbndr
bkc: bkcy
bke: knobkerrie
bkg: bkgd
bkh: abkhasian
bki: subkingdoms
bkl: bklr
bkp: bkpr
bks: bks
bkt: bkt
bku: lebkuchen
bla: semiblasphemousness
bld: bldg
ble: superincomprehensibleness
bli: antidisestablishmentarianism
blk: blksize
blm: ennoblment
bln: receivablness
blo: blockheadishness
bls: bbls
blu: blunderheadedness
blv: blvd
bly: superincomprehensibly
bma: submakroskelic
bme: nonsubmergibility
bmh: abmhos
bmi: submicroscopically
bmo: submontaneous
bms: dbms
bmu: submultiplexed
bmy: submytilacea
bna: alveolosubnasal
bnd: bkbndr
bne: nonimpressionabness
bnf: bnf
bni: leibnitzianism
bno: superabnormally
bnu: subnutritiousness
boa: overboastfulness
bob: amoebobacterieae
boc: carbocinchomeronic
bod: cubododecahedral
boe: diethylstilboestrol
bof: tribofluorescence
bog: phlebographical
boh: pseudorhombohedral
boi: poluphloisboiotatotic
boj: plumbojarosite
bok: thrombokinase
bol: hyperdiabolicalness
bom: superabominableness
bon: desoxyribonucleoprotein
boo: overbookishness
bop: pylethrombophlebitis
boq: rhomboquadratic
bor: noncorroboratively
bos: laryngostroboscope
bot: ophthalmophlebotomy
bou: tuberculatogibbous
bov: bovovaccination
bow: bowdlerizations
box: propanedicarboxylic
boy: schoolboyishness
boz: aburabozu
bpa: subpartitionment
bpe: subperpendicular
bph: subpharyngeally
bpi: subpilosity
bpl: subplantigrade
bpo: subpostmastership
bpr: subprofessionally
bps: kbps
bpt: bpt
bpu: subpunctuation
bpy: subpyramidical
bqu: subquadrangular
bra: pseudolamellibranchiata
brd: heathbrd
bre: bretschneideraceae
brh: subrhomboidal
bri: brigantinebrigantines
brl: brl
brn: dbrn
bro: tetrabromofluorescein
brr: brrr
bru: overbrutalization
bry: mesembryanthemaceae
bsa: subsatiricalness
bsb: habsburg
bsc: oversubscription
bsd: lambsdown
bse: overobsequiousness
bsf: absfarad
bsh: bombshells
bsi: intersubsistence
bsk: lambskins
bsl: bobsledders
bsm: swellmobsman
bsn: subsneer
bso: nonabsolutistically
bsp: subspontaneousness
bsq: absquatulation
bss: tbssaraglot
bst: transubstantiationalist
bsu: subsultorysubsultus
bsv: absvolt
bsy: subsyndication
bta: unobtainableness
bte: subterraneanizing
btf: undoubtfulness
bth: schraubthaler
bti: supersubtilized
btl: oversubtleties
btm: doubtmonger
bto: subtotalling
btr: preobtrudingpreobtrusion
bts: doubtsome
btu: subturriculated
btw: subtwined
bty: subtympanitic
bua: subtribual
bub: beelzebubian
buc: buccopharyngeal
bud: unbudgeableness
bue: buettneriaceae
buf: buffoonishness
bug: antihumbuggist
buh: buhlworks
bui: counterbuilding
buj: cabuja
buk: rebukefulness
bul: mandibulosuspensorial
bum: gastroalbuminorrhea
bun: supersuperabundantly
buo: nonbuoyantly
bup: buphthalmia
buq: albuquerque
bur: semibureaucratically
bus: incombustibleness
but: azoisobutyronitrile
buu: incunabuulum
buv: buvette
bux: buxbaumiaceae
buy: unbuyableness
buz: buzzardlike
bva: subvaluation
bve: nonsubversiveness
bvi: subvitalisation
bvo: obvolution
bvt: bvt
bwa: subwardenship
bwe: cobwebbiest
bwh: bobwhites
bwi: barbwires
bwo: scrubwoman
bwr: combwright
bxe: pbxes
bxs: bxs
bya: presbyacousia
byb: byblidaceae
byc: bombycillidae
byd: babydom
bye: byelorussians
byf: babyfied
byg: byganging
byh: hobbyhorsically
byi: babyishness
byl: panbabylonian
bym: lobbyman
byn: bynedestin
byo: presbyophrenia
byp: byproducts
byr: labyrinthibranchiate
bys: abyssobenthonic
byt: archpresbyterate
byu: cambyuskan
byw: bywalking
byx: bombyxes
byy: cubbyyew
byz: byzantinesque
bze: subzero
bzh: dobzhansky
bzi: sabzi
bzo: subzonary
bzu: ribzuba
bzy: subzygomatic
caa: balmacaan
cab: historicocabbalistical
cac: hydroxybutyricacid
cad: pseudoacademically
cae: tessarescaedecahedron
caf: decaffeinating
cag: juncaginaceous
cah: tessarescaedecahedron
cai: rachiococainize
caj: cajolements
cak: griddlecakes
cal: electroencephalographically
cam: antepredicamental
can: macracanthrorhynchiasis
cao: caoutchoucin
cap: anticapitalistically
caq: caqueteuses
car: electrocardiographically
cas: supersarcastically
cat: counterclassifications
cau: electrocauterization
cav: vesiculocavernous
caw: americawards
cax: caxtonian
cay: undecayableness
caz: guadalcazarite
cba: bacbakiri
cbe: macbeth
cbi: tropicbird
cbl: ecblastesis
cbm: icbm
cbn: dcbname
cbo: arcboutant
cbr: sacbrood
cbu: sacbuts
cca: electrodesiccation
ccc: pasticcci
cce: cardioaccelerator
cch: heteropolysaccharide
cci: succinylsulphathiazole
cck: cckw
ccl: antiecclesiastically
ccm: ccm
cco: nonaccommodatingness
ccr: preconseccrating
cct: hecctkaerre
ccu: nonaccumulativeness
ccw: ccws
ccy: arteriococcygeal
cda: ducdame
cde: ecderonic
cdf: cdf
cdg: cdg
cdi: myocdia
cdo: synecdochically
cdr: cdr
cdu: macduff
cdy: anecdysis
cea: chlamydobacteriaceae
ceb: serviceberries
cec: splanchnicectomies
ced: heteroscedasticity
cee: superexceeding
cef: unresourcefulness
ceg: antimiscegenation
ceh: nonofficeholding
cei: tetrabromofluorescein
cej: lancejack
cek: peacekeepers
cel: encephalomeningocele
cem: counterannouncement
cen: astrospherecentrosomic
ceo: chlamydobacteriaceous
cep: electroencephalographically
ceq: acequiador
cer: phosphoglyceraldehyde
ces: americanumancestors
cet: acetylphenylhydrazine
ceu: chemicopharmaceutical
cev: proparasceve
cew: consciencewise
cey: ceyssatite
cez: cezannesque
cfa: macfarlane
cfd: cfd
cfh: scfh
cfi: cfi
cfl: macflecknoe
cfm: scfm
cfo: arcform
cfs: cfs
cfu: frolicful
cge: folcgemot
cgi: eucgia
cgm: cgm
cgo: ecgonine
cgr: marcgraviaceous
cgs: cgs
cgy: gynecicgynecidal
cha: noninterchangeableness
chb: scharlachberger
chc: archconfraternities
chd: archdapifership
che: chemicopharmaceutical
chf: unreproachfulness
chg: archgenethliac
chh: archhypocrisy
chi: macracanthrorhynchiasis
chj: archjockey
chk: gemutlichkeit
chl: dichlorodiphenyltrichloroethane
chm: counteravouchment
chn: countertechnicality
cho: philosophicopsychological
chp: archpresbyterate
chr: photochronographically
chs: archsacrificator
cht: ichthyopaleontology
chu: protocatechualdehyde
chv: zilchviticetum
chw: churchwardenship
chy: hypsibrachycephalism
chz: scheuchzeriaceous
cia: counterpronunciamento
cib: ineffervescibility
cic: antistaphylococcic
cid: coccidioidomycosis
cie: scientificophilosophical
cif: dihdroxycholecalciferol
cig: fluorescigenous
cii: coraciiformes
cij: paucijugate
cil: saccharomucilaginous
cim: quartodecimanism
cin: cineangiocardiographic
cio: anthroposociologist
cip: antidisciplinarian
ciq: caciqueship
cir: circumparallelogram
cis: antiecclesiasticism
cit: magnetothermoelectricity
ciu: chartophylacium
civ: overlasciviousness
ciw: ciwies
cix: cixiidae
ciz: overromanticizing
cka: lackadaisicalness
ckb: backbonelessness
ckc: backcourtman
ckd: sneckdrawing
cke: chickenheartedness
ckf: chuckfarthing
ckg: blackguardism
ckh: blackheartedness
cki: unbluestockingish
ckj: blackjacking
ckk: knickknackatory
ckl: chuckleheadedness
ckm: slackmindedness
ckn: disacknowledgements
cko: counterreckoning
ckp: crackpottedness
ckq: cuckquean
ckr: rackrentable
cks: quicksilverishness
ckt: pickthankness
cku: feckulence
ckv: backvelder
ckw: counterclockwise
ckx: kickxia
cky: weathercocky
cla: counterclassifications
clc: androclclinia
cle: desoxyribonucleoprotein
cli: demethylchlortetracycline
clk: clk
cln: anticlnoria
clo: cyclotrimethylenetrinitramine
clr: clr
clu: superinclusiveness
cly: chamaepericlymenum
cma: acmaesthesia
cmd: ftncmd
cme: acmesthesia
cmi: macmillanite
cml: cml
cmn: ecmnesia
cmo: panicmongering
cmu: lacmus
cmy: synacmy
cna: pycnanthemum
cne: chemotherapeuticness
cni: pycnidiophore
cno: heteropycnosis
cnt: imcnt
cnu: bonducnut
coa: theologicoastronomical
cob: aquopentamminecobaltic
coc: historicocabbalistical
cod: pancreaticoduodenostomy
coe: hepaticoenterostomies
cof: silicoferruginous
cog: scientificogeographical
coh: pathologicohistological
coi: mechanicointellectual
coj: philosophicojuristic
cok: pharmacokinetics
col: laparocolpohysterotomy
com: superincomprehensibleness
con: blepharoconjunctivitis
coo: noncooperationist
cop: philosophicopsychological
coq: uncoquettishness
cor: hydroxydehydrocorticosterone
cos: hydroxydehydrocorticosterone
cot: philosophicotheological
cou: counterclassifications
cov: undiscoverableness
cow: pericowperitis
cox: coxankylometer
coy: overcoyness
coz: medicozoologic
cpa: tecpanec
cpd: cpd
cpe: peroxidicperoxiding
cph: ecphorization
cpi: pincpinc
cpl: cpl
cpm: cpm
cpn: uucpnet
cpo: superphysicposing
cpr: staticproof
cps: cps
cpt: recpt
cpu: cputime
cqu: nonacquaintanceship
cra: macracanthrorhynchiasis
crc: simulacrcra
cre: pancreaticoduodenostomy
crf: concrfsce
cri: pharmacoendocrinology
crl: macrli
crn: geometdecrne
cro: microspectrophotometrically
crp: crpe
crs: crs
crt: crts
cru: overscrupulousness
crw: crwths
cry: dacryocystoblennorrhea
crz: crzette
csa: specsartine
csc: csch
cse: csects
csh: criticship
csi: telefacsimile
csk: csk
csl: focsle
csm: criticsm
csn: csnet
cso: frolicsomeness
csp: calcspars
cst: nonecstatically
csw: csw
csy: lcsymbol
cta: superrespectableness
ctc: directcarving
ctd: directdiscourse
cte: blepharosphincterectomy
ctf: overneglectfulness
ctg: actg
cth: galacthidrosis
cti: blepharoconjunctivitis
ctk: hecctkaerre
ctl: contradistinctly
ctm: superindictment
ctn: noncircumspectness
cto: thyroparathyroidectomize
ctp: neglectproof
ctr: electroencephalographically
cts: microarchitects
ctt: objecttification
ctu: overintellectualization
ctw: respectworthy
cty: palaeodictyopterous
ctz: hoactzines
cua: interarcualis
cub: aquintocubitalism
cuc: cucurbitaceous
cud: incudostapedial
cue: recueillement
cuf: fisticuffery
cug: cuggermugger
cui: noncircuitousness
cuj: cucujidae
cuk: cukes
cul: pneumoventriculography
cum: circumparallelogram
cun: superfecundation
cuo: nonpromiscuousness
cup: nonrecuperativeness
cur: countercurrentwise
cus: antistreptococcus
cut: nonconsecutiveness
cuu: nonvacuums
cuv: cuvierian
cuy: cocuyo
cuz: cuzceno
cvr: rcvr
cwa: arcticwards
cwe: colicweed
cwi: baldricwise
cwm: cwms
cwo: garlicwort
cwr: decwriter
cws: ccws
cwt: cwt
cxo: acxoyatl
cya: cyanomethaemoglobin
cyb: cybernetically
cyc: cyclotrimethylenetrinitramine
cyd: encydlopaedic
cye: salpingocyesis
cyg: arteriococcygeal
cyh: policyholders
cyi: fancying
cyk: cyke
cyl: turbinatocylindrical
cym: lautenclavicymbal
cyn: supercynicalness
cyo: procyoniformia
cyp: cyprinodontidae
cyr: thoracocyrtosis
cys: cholecystenterorrhaphy
cyt: cytospectrophotometry
cyu: cyul
cyw: fancywork
cyx: sacrococcyx
cyz: cyzicene
cza: czarevitch
cze: czechoslovakians
czi: czigany
daa: rijksdaalder
dab: superformidableness
dac: dacryocystoblennorrhea
dad: dadaistically
dae: chlamydoselachidae
daf: daffadowndillies
dag: nonpedagogically
dah: kjeldahlization
dai: lackadaisicalness
daj: koldaji
dak: satyashodak
dal: pharyngoamygdalitis
dam: chlorprophenpyridamine
dan: supersuperabundantly
dao: endaortitis
dap: superadaptableness
daq: andaquian
dar: ultrastandardization
das: aminopolypeptidase
dat: nonaccommodatingness
dau: undaughterliness
dav: cadaverousness
daw: dawsoniaceous
dax: midaxillary
day: holidaymaking
daz: benzimidazole
dba: threadbareness
dbe: standardbearers
dbh: tadbhava
dbi: speckledbill
dbk: hdbk
dbl: coldbloodedness
dbm: dbms
dbo: speedboating
dbr: struldbruggian
dbu: woodburytype
dby: standbybys
dca: radiobroadcasters
dcb: dcbname
dce: deadcenter
dch: stepgrandchild
dcl: handclapping
dco: coevolvedcoevolves
dcr: woodcraftiness
dcu: bloodcurdlingly
dcy: invalidcy
dda: granddaughterly
ddb: oddballs
ddd: addda
dde: demigoddessship
ddf: eisteddfodism
ddh: sarvarthasiddha
ddi: jackpuddinghood
ddl: intermeddlesomeness
ddm: oddments
ddn: oddnesses
ddo: armageddonist
ddr: addressability
dds: superadds
ddt: ddt
ddu: biddulphiaceae
ddy: magnetofluiddynamics
dea: deanthropomorphization
deb: debituminization
dec: thyroparathyroidectomize
ded: unabsentmindedness
dee: irredeemableness
def: epididymodeferentectomy
deg: erythrodegenerative
deh: hydroxydehydrocorticosterone
dei: deinstitutionalization
dej: fidejussionary
dek: triskaidekaphobes
del: adelarthrosomatous
dem: demethylchlortetracycline
den: pancreaticoduodenostomy
deo: deoxyribonucleoprotein
dep: autodepolymerization
deq: superadequateness
der: anticonfederationism
des: hydroxydesoxycorticosterone
det: nondeterminativeness
deu: sternocleidomastoideus
dev: counterdevelopment
dew: tidewaitership
dex: pseudoambidextrously
dey: goliardeys
dez: dezincification
dfa: oversteadfastness
dfe: bedfellowship
dff: adffrozen
dfi: hardfistedness
dfl: groundflower
dfo: blindfoldedness
dfr: breadfruits
dft: bdft
dfu: disregardfulness
dga: knowledgableness
dge: disacknowledgements
dgh: dghaisa
dgi: preacknowledging
dgk: hodgkinsonite
dgl: fluidglycerate
dgm: superacknowledgment
dgo: grandgore
dgr: landgraveship
dgs: judgship
dgu: bloodguiltiness
dgw: wedgwood
dgy: porridgy
dha: secondhandedness
dhe: semiadhesiveness
dhi: ardhamagadhi
dhj: trondhjemite
dho: antistadholderian
dhp: jodhpurs
dhr: dhritarashtra
dhs: hlidhskjalf
dhu: goodhumoredness
dhv: madhva
dhy: iodhydrate
dia: pericardiomediastinitis
dib: mandibulosuspensorial
dic: dichlorodiphenyltrichloroethane
did: epididymodeferentectomy
die: dicyclopentadienyliron
dif: dichlorodifluoromethane
dig: antiprestidigitation
dih: dihdroxycholecalciferol
dii: actinomyxidiida
dij: dijudicating
dik: dimethyldiketone
dil: bronchodilatation
dim: dimethylanthranilate
din: preobtrudingpreobtrusion
dio: electrocardiographically
dip: dichlorodiphenyltrichloroethane
diq: anthradiquinone
dir: directexamination
dis: antidisestablishmentarianism
dit: scleroticochorioiditis
diu: hydropneumopericardium
div: overindividualistically
diw: handiwork
dix: ipsedixitish
diy: butadiyne
diz: ultrastandardization
dja: superadjacently
dje: nonadjectivally
dji: comitadji
djo: nonadjournment
djt: adjt
dju: nonadjudicatively
djy: takhtadjy
dka: gladkaite
dke: handkerchiefful
dkf: hdkf
dkg: dkg
dki: bodkinwise
dkl: dkl
dkm: dkm
dkn: clodknocker
dko: diadkokinesia
dks: dks
dla: newfoundlander
dlc: hdlc
dld: stradld
dle: intermeddlesomeness
dli: otherworldliness
dlo: encydlopaedic
dlr: dlr
dls: dirndls
dlu: landlubberish
dlv: dlvy
dly: westnorthwestwardly
dma: headmastership
dme: magnetofluidmechanics
dmi: nonadministratively
dmo: grandmotherliness
dmp: stddmp
dmr: admrx
dmu: khidmutgar
dna: goodnaturedness
dnc: precednce
dne: unstraightforwardness
dni: prednisolone
dnl: addnl
dno: superdreadnought
dnt: shouldnt
dnu: breadnuts
dny: fadednyess
doa: pseudoaristocratically
dob: chlamydobacteriaceous
doc: choledochoduodenostomy
dod: pseudodemocratically
doe: pseudoenthusiastically
dof: cathodofluorescence
dog: prorhipidoglossomorpha
doh: pseudohermaphroditism
doi: pseudointernationalistic
doj: pseudojervine
dok: adiadokokinesia
dol: pseudolamellibranchiata
dom: pseudomonocotyledonous
don: pseudomonocotyledonous
doo: pseudoorthorhombic
dop: tetraiodophenolphthalein
doq: pseudoquinol
dor: appendorontgenography
dos: pseudosacrilegiously
dot: lymphangioendothelioma
dou: doubleheartedness
dov: pseudoviperously
dow: daffadowndillies
dox: nonparadoxicalness
doy: pseudoyohimbine
doz: pseudozoological
dpa: grandparenthood
dpe: hundredpenny
dph: headphones
dpi: codpitchings
dpl: cardplaying
dpo: gonopodpodia
dpr: preinferredpreinferring
dpt: dpt
dpu: mudpuppies
dqr: hdqrs
dqu: subheadquarters
dra: dinitrophenylhydrazine
drc: drch
drd: clinandrdria
dre: adrenocorticosteroid
dri: turbinatocylindrical
drm: bdrm
dro: hydroxydehydrocorticosterone
dru: quadrupedantical
dry: dryopithecinae
dsa: handsawfishes
dsb: gadsbodikins
dsc: adscititiously
dse: forwardsearch
dsf: houndsfoot
dsh: understewardship
dsi: secondsightedness
dsk: groundskeeping
dsl: hildebrandslied
dsm: landsmanshaften
dsn: podsnappery
dso: outwardsoutwarred
dsp: feldspathization
dsq: headsquare
dsr: dsri
dst: bloodstainedness
dsu: bloodsuckers
dsw: wordsworthianism
dsy: backwoodsy
dta: lizardtail
dtd: dtd
dte: goodtemperedness
dth: bloodthirstiness
dti: humboldtilite
dtl: imdtly
dto: beardtongue
dtr: soundtracks
dts: staroobriadtsi
dtu: woodturning
dty: wildtype
dua: overindividualistically
dub: dubiocrystalline
duc: counterproductiveness
dud: clapperdudgeon
due: undergraduette
duf: dufrenoysite
dug: skullduggeries
duh: baduhenna
dui: disassiduity
duj: dujan
duk: archdukedom
dul: periosteomedullitis
dum: dumbfounderment
dun: corticopeduncular
duo: pancreaticoduodenostomy
dup: photoduplication
duq: belduque
dur: microprocedures
dus: overindustrialization
dut: unduteousness
duu: individuums
duv: aberduvine
dux: archduxe
duy: tamanduy
duz: reduzate
dva: predisadvantageously
dve: nonadventitiousness
dvi: inadvisableness
dvo: preadvocating
dvt: advt
dwa: scotlandwards
dwe: hundredweights
dwh: treadwheel
dwi: uninterferedwith
dwl: oidwlfe
dwo: roadworthiness
dwr: shorthandwriter
dwt: dwt
dwu: redwud
dwy: odwyer
dxt: fldxt
dya: dyakisdodecahedron
dyb: bodybuilders
dyc: bradycinesia
dyd: bradydactylia
dye: bradyesthesia
dyf: ladyfingers
dyg: bradyglossia
dyh: sturdyhearted
dyi: ultradandyism
dyk: bradykinesia
dyl: spondylotherapeutics
dym: epididymodeferentectomy
dyn: magnetohydrodynamically
dyo: dyophysitical
dyp: palaeeudyptes
dyr: eddyroot
dys: blepharodyschroia
dyt: bradyteleocinesia
dyu: bradyuria
dyv: dyvours
dyw: tiddledywinks
dyx: sandyx
dza: akhundzada
dze: dzeren
dzh: nudzh
dzi: phloridzin
dzo: podzolization
dzu: dzungar
eaa: steaakhouse
eab: noninterchangeableness
eac: isopropylideneacetone
ead: blunderheadedness
eae: chlamydobacteriaceae
eaf: deafforestation
eag: colleaguesmanship
eah: enneahedrons
eai: liebgeaitor
eak: heartbreakingly
eal: glossolabiopharyngeal
eam: oversqueamishness
ean: cineangiocardiographic
eao: preaortic
eap: reapportionments
eaq: deaquation
ear: chickenheartedness
eas: desoxyribonuclease
eat: pancreaticoduodenostomy
eau: semibureaucratically
eav: heavyheartedness
eaw: unseaworthiness
eax: preaxially
eay: macleaya
eaz: benzeneazobenzene
eba: phlebarteriodialysis
ebb: pebblehearted
ebc: ascebc
ebd: hebdomadaries
ebe: semirebelliousness
ebf: liebfraumilch
ebg: liebgeaitor
ebh: lebhaft
ebi: pylethrombophlebitis
ebk: lebkuchen
ebl: feebleheartedness
ebm: webmaking
ebo: ophthalmophlebotomy
ebr: brigantinebrigantines
ebs: klebsiella
ebt: preindebtedness
ebu: unrebuttableness
ebw: webwheel
eby: forebye
eca: dihdroxycholecalciferol
ecb: ecblastesis
ecc: antiecclesiastically
ecd: synecdochically
ece: astrospherecentrosomic
ecg: ecgonine
ech: diphenylaminechlorarsine
eci: overappreciativeness
eck: counterreckoning
ecl: counterdeclaration
ecm: ecmnesia
ecn: tecnoctonia
eco: aquopentamminecobaltic
ecp: ecphorization
ecq: becquerelite
ecr: supersecretiveness
ecs: nonecstatically
ect: electroencephalographically
ecu: hyperspeculativeness
ecw: decwriter
ecy: cholecystenterorrhaphy
ecz: eczematization
eda: heteroscedasticity
edb: crookedbacked
edc: coevolvedcoevolves
edd: intermeddlesomeness
ede: tessarescaedecahedron
edf: bedfellowship
edg: disacknowledgements
edh: redhandedness
edi: pericardiomediastinitis
edj: medjidieh
edk: weedkiller
edl: preterdeterminedly
edm: depiedmontize
edn: uncircumscribedness
edo: choledochoduodenostomy
edp: preinferredpreinferring
edq: bedquilts
edr: tessarescaedecahedron
eds: thoroughbreds
edt: cronstedtite
edu: periosteomedullitis
edw: uninterferedwith
edy: comicotragedy
eea: unforeseeableness
eeb: feebleheartedness
eec: palaeechinoidean
eed: threedimensionality
eee: whenceeer
eef: bumblebeefishes
eeg: coffeegrowing
eeh: freeheartedness
eei: superguaranteeing
eej: reejecting
eek: meekheartedness
eel: freewheelingness
eem: eleemosynariness
een: preencouragement
eeo: gweeon
eep: housekeeperlike
eeq: preequalization
eer: chemicoengineering
ees: cheesemongering
eet: palaeethnological
eeu: palaeeudyptes
eev: preevolutionary
eew: freewheelingness
eex: preextinguishment
eey: mashrebeeyah
eez: dehydrofreezing
efa: indefatigableness
efb: beefburgers
efc: briefcases
efd: chiefdoms
efe: epididymodeferentectomy
eff: ineffervescibility
efg: trefgordd
efh: beefheaded
efi: nonbeneficialness
efl: overreflectiveness
efm: thiefmaking
efn: unbriefness
efo: counterreformation
efp: thiefproof
efr: microrefractometer
efs: handkerchiefs
eft: chieftainships
efu: defunctionalization
efw: beefwoods
efy: nonliquefying
efz: alefzero
ega: steganophthalmatous
egb: pegboards
egd: regd
ege: regeneratoryregeneratress
egf: siegfried
egg: beggiatoaceous
egh: alleghenian
egi: pseudosacrilegiously
egk: kellegk
egl: overneglectfulness
egm: sanguineophlegmatic
egn: stegnosisstegnotic
ego: syncategorematically
egp: legpulling
egq: negqtiator
egr: phototelegraphically
egs: beglerbegship
egt: pegtops
egu: musculotegumentary
egw: legworks
egy: egyptianization
eha: behavioristically
ehb: rehboc
ehe: superincomprehensibleness
ehg: dehgan
ehi: prehistorically
ehk: dehkan
ehl: muehlenbeckia
ehm: vehmgericht
ehn: dehnstufe
eho: hobbledehoyishness
ehr: ehretiaceae
ehs: tehseeldar
eht: ehtanethial
ehu: literaehumaniores
ehw: dehwar
ehy: hydroxydehydrocorticosterone
eia: plebeianisation
eib: leibnitzianism
eic: fideicommissumissa
eid: sternocleidomastoideus
eie: freieslebenite
eif: hyperdeification
eig: unneighbourliness
eih: teihte
eii: dromiceiidae
eij: infeijdation
eik: aniseikonia
eil: cheilodipteridae
eim: hypokeimenometry
ein: tetraiodophenolphthalein
eio: stoicheiometrically
eip: deipnodiplomatic
eir: oneirocritically
eis: microseismometrograph
eit: precontemporaneity
eiu: cassiopeium
eiv: inconceivabilities
eix: apodeixis
eiy: seiyuhonto
eiz: homogeneization
eja: antiejaculation
ejd: nejdi
eje: antejentacular
eji: rejiggering
ejo: nonpejoratively
eju: cholecystojejunostomy
eka: triskaidekaphobes
ekb: cheekbones
ekc: kekchi
ekd: greekdom
eke: housekeeperlike
ekf: creekfishes
ekh: meekheartedness
eki: telekinematography
ekk: steekkannen
ekl: kaffeeklatsch
ekm: beekmantown
ekn: foreknowableness
eko: meekoceras
ekp: shriekproof
ekr: ekronite
eks: koeksotenok
ekt: ektodynamorphic
eku: akanekunik
ekw: weekwam
eky: boydekyn
ela: nonrelativistically
elb: wheelbarrowful
elc: pancreathelcosis
eld: elderbrotherhood
ele: electroencephalographically
elf: unselfconsciousness
elg: doppelganger
elh: levelheadedness
eli: lymphangioendothelioma
elj: kabbeljaws
elk: kestrelkestrels
ell: overintellectualization
elm: helminthocladiaceae
eln: unparallelness
elo: ureteropyelonephritis
elp: christadelphianism
elq: quelquechose
elr: gabrielrache
els: siliceofelspathic
elt: helterskelteriness
elu: preluxuriousness
elv: pelveoperitonitis
elw: wheelwrighting
ely: overrepresentatively
elz: beelzebubian
ema: hematospectrophotometer
emb: membranocartilaginous
emc: clemclemalats
emd: novemdecillionth
eme: demethylchlortetracycline
emf: septemfoliolate
emg: emgalla
emh: emhpasizing
emi: chemicopharmaceutical
emj: decemjugate
eml: kremlinologists
emm: broncholemmitis
emn: countercondemnation
emo: anemometrographically
emp: noncontemporaneousness
emr: heemraad
ems: bremsstrahlung
emt: geoemtry
emu: unremunerativeness
emv: quindecemvirate
emw: problemwise
emy: demythologizations
emz: chremzlach
ena: pseudophenanthroline
enb: manganhedenbergite
enc: electroencephalographically
end: lymphangioendothelioma
ene: cyclotrimethylenetrinitramine
enf: disenfranchisements
eng: counterdisengagement
enh: chickenheartedness
eni: encephalomeningocele
enj: unenjoyableness
enk: schwenkfeldian
enl: preenlightenment
enm: preenlightenment
enn: dacryocystoblennorrhea
eno: tetraiodophenolphthalein
enp: chlorprophenpyridamine
enq: unenquiring
enr: undercitizenries
ens: superincomprehensibleness
ent: antidisestablishmentarianism
enu: nondisingenuousness
env: antienvironmentalists
enw: heavenwardness
eny: dichlorodiphenyltrichloroethane
enz: alkylbenzenesulfonates
eoa: calcareoargillaceous
eob: preobtrudingpreobtrusion
eoc: palaeoclimatological
eod: palaeodendrologically
eoe: palaeoentomological
eof: stereofluoroscopic
eog: scientificogeographical
eoh: palaeoherpetologist
eoi: diastereoisomerism
eok: bradyteleokinesis
eol: philosophicotheological
eom: stereomicroscopically
eon: micropaleontological
eoo: neoorthodoxy
eop: desoxyribonucleoprotein
eor: stereoroentgenography
eos: cholecystoileostomy
eot: homeotransplantation
eou: noncontemporaneousness
eov: sulphureovirescent
eow: neowashingtonia
eox: deoxyribonucleoprotein
eoy: paleoytterbium
eoz: palaeozoological
epa: hepaticoenterostomies
epb: stepbrotherhood
epc: stepchildren
epd: stepdaughters
epe: noninterdependently
epf: sheepfacedness
epg: stepgrandfather
eph: electroencephalographically
epi: epididymodeferentectomy
epk: sheepkeeping
epl: irreplaceableness
epm: stepmotherliness
epn: deepnesses
epo: autodepolymerization
epp: steppingstones
epq: nepquite
epr: nonrepresentationalism
eps: pepsinhydrochloric
ept: conceptualistically
epu: aristorepublicanism
epw: sweepwashings
epy: aepyornithiformes
eqd: reqd
eqe: seqence
eqf: seqfchk
eqp: eqpt
eqq: seqq
eqr: seqrch
equ: nonconsequentialness
eqw: beqwete
era: regeneratoryregeneratress
erb: hyperbrachycephalic
erc: counterclassifications
erd: interdenominationalism
ere: blepharosphincterectomy
erf: hyperfastidiousness
erg: overgesticulativeness
erh: hyperhemoglobinemia
eri: superincomprehensibleness
erj: interjectionalising
erk: hyperkatabolism
erl: counterlegislation
erm: magnetothermoelectricity
ern: pseudointernationalistic
ero: hydroxydehydrocorticosterone
erp: counterinterpretation
erq: overqualification
err: preinferredpreinferring
ers: oversuperstitiousness
ert: intertransformability
eru: superultrafrostified
erv: hyperconservativeness
erw: otherworldliness
erx: interxylary
ery: archaeopterygiformes
erz: interzygapophysial
esa: platymesaticephalic
esb: archpresbyterate
esc: crystalloluminescence
esd: mesdemoiselles
ese: nonrepresentationalism
esf: breechesflower
esg: salesgirls
esh: nonacquaintanceship
esi: immunoelectrophoresis
esk: threskiornithidae
esl: freieslebenite
esm: blepharosyndesmitis
esn: semirattlesnake
eso: hydroxydesoxycorticosterone
esp: superrespectableness
esq: sesquicentennially
esr: salesrooms
ess: regeneratoryregeneratress
est: antidisestablishmentarianism
esu: formaldehydesulphoxylate
esv: charlottesville
esw: spokeswomanship
esy: presystematically
esz: veszelyite
eta: theologicometaphysical
etb: acetbromamide
etc: electroetching
etd: geometdecrne
ete: hematospectrophotometer
etf: unforgetfulness
etg: voetganger
eth: dichlorodiphenyltrichloroethane
eti: immunoelectrophoretically
etj: koggelmannetje
etk: wicketkeeping
etl: beetleheadedness
etm: acetmethylanilide
etn: overdiscreetness
eto: magnetothermoelectricity
etp: acetphenetidin
etr: cyclotrimethylenetrinitramine
ets: bretschneideraceae
ett: carettochelydidae
etu: quinquetuberculate
etv: chetverik
etw: internetworking
ety: acetylphenylhydrazine
etz: nietzscheanism
eua: euascomycetes
eub: eubacteriales
euc: ophthalmoleucoscope
eud: pseudointernationalistic
eue: euemerism
euf: euflavine
eug: zeugobranchiata
euh: euhemeristically
eui: feuilletonistic
euk: hyperleukocytosis
eul: eulamellibranchiata
eum: hydropneumopericardium
eun: preunderstanding
euo: sceuophylacium
eup: noneuphoniousness
eur: neurochorioretinitis
eus: sternocleidomastoideus
eut: chemicopharmaceutical
euv: countermaneuver
euw: spreeuw
eux: clarenceuxship
euz: hakenkreuzler
eva: pseudoevangelically
evc: devchar
eve: counterdevelopment
evg: evg
evi: superdevilishness
evl: nievling
evm: tradevman
evn: czarevnas
evo: counterrevolutionaries
evr: chevronelly
evs: lobachevskian
evu: devulcanization
evv: revving
evw: devwsor
evy: nevyanskite
evz: evzones
ewa: understewardship
ewb: curlewberry
ewc: dewclawed
ewd: overlewdness
ewe: pestilenceweed
ewf: newfangledness
ewg: clewgarnet
ewh: freewheelingness
ewi: housewifeliness
ewk: beetewk
ewl: viewlessness
ewm: bestrewment
ewn: overstrewn
ewo: gentlewomanliness
ewp: screwpropeller
ewr: teletypewriters
ews: newspaperwoman
ewt: bartholomewtide
ewu: curliewurlie
eww: viewworthy
ewy: corkscrewy
exa: hexahydroxycyclohexane
exc: counterexcommunication
exd: sexdecillions
exe: dishexecontahedroid
exf: exflagellation
exg: exgorgitation
exh: nonexhibitionistic
exi: existentialistically
exl: indexlessness
exm: perplexment
exn: uncomplexness
exo: hexosemonophosphoric
exp: counterexpostulation
exq: superexquisiteness
exr: sexradiate
exs: exstemporaneous
ext: pseudoambidextrously
exu: overexuberantness
exx: exxon
exy: gastrohysteropexy
exz: exzodiacal
eya: conveyability
eyb: barleybrake
eyc: moneychangers
eyd: turveydropdom
eye: unhackneyedness
eyf: cockneyfication
eyg: moneygrubbing
eyh: honeyhearted
eyi: photosurveying
eyj: freyja
eyk: domeykite
eyl: moneylessness
eym: honeymoonstruck
eyn: keynesianism
eyo: conveyorization
eyp: chimneypiece
eyr: aleyrodidae
eys: subattorneyship
eyt: monkeytail
eyu: eeyuch
eyv: parleyvoo
eyw: journeyworker
eyx: ceyx
eyy: snarleyyow
eza: squeezableness
ezb: rezbanyite
ezc: tezcatzoncatl
ezd: ouyezd
eze: dehydrofreeze
ezg: lezghian
ezh: brezhnev
ezi: trapeziometacarpal
ezk: tezkirah
ezl: freiezlebenhe
ezm: klezmer
ezn: wezn
ezo: piezocrystallization
ezp: bezpopovets
ezq: mezquites
ezr: hezronites
ezu: venezuelans
ezv: rendezvousing
ezy: praezygapophysis
ezz: nonembezzlement
faa: faailk
fab: confabulations
fac: brachiofaciolingual
fad: daffadowndillies
fae: raffaelesque
faf: azelfafage
fag: sulfaguanidine
fah: fahlunitte
fai: unfaithworthiness
faj: khafajeh
fak: clyfaking
fal: nonfallaciousness
fam: sulfamethylthiazole
fan: sulfanilylguanidine
fao: entfaoilff
fap: sulfapyrazine
faq: sulfaquinoxaline
far: faradocontractility
fas: hyperfastidiousness
fat: phthalylsulfathiazole
fau: unfaultfinding
fav: overfavorableness
faw: fawningness
fax: hrimfaxi
fay: fayalites
faz: unfazedness
fba: goofballs
fbe: wolfberries
fbi: surfbirds
fbl: halfblood
fbo: surfboarding
fbr: offbreak
fbu: beefburgers
fca: surfcasting
fch: chiffchaff
fci: sheriffcies
fco: unselfconsciousness
fcp: fcp
fcr: thiefcraft
fcs: fcs
fcu: chaffcutter
fcy: sheriffcy
fda: tarafdar
fde: afdecho
fdi: wafdist
fdn: fdnames
fdo: sheriffdom
fdt: fdtype
fdu: fdubs
fea: nondefeasibleness
feb: febricitation
fec: pseudoaffectionately
fed: anticonfederationism
fee: feebleheartedness
fef: hassenpfeffer
feg: unsafeguarded
feh: lifeholder
fei: counterfeisance
fek: safekeeping
fel: nonfelicitousness
fem: femorococcygeal
fen: superoffensiveness
feo: diffeomorphism
fep: strifeproof
fer: dihdroxycholecalciferol
fes: semiprofessionalized
fet: farfetchedness
feu: antifeudalization
fev: pseudofeverishly
few: featherfew
fex: carnifexes
fey: feynesses
fez: terfeziaceae
ffa: daffadowndillies
ffb: snuffboxer
ffc: snuffcolored
ffd: sheriffdom
ffe: interdifferentiating
ffg: stuffgownsman
ffh: offhandedness
ffi: overaffirmativeness
ffk: tscheffkinite
ffl: superaffluently
ffm: enfeoffment
ffn: stiffneckedness
ffo: daffodowndillies
ffp: offprinting
ffr: nondiffractiveness
ffs: undersheriffship
fft: stifftail
ffu: interdiffusiveness
ffw: undersheriffwick
ffy: daffydowndilly
fga: giffgaff
fge: palfgeys
fgh: afghanistan
fgi: leafgirl
fgn: fgn
fgo: stuffgownsman
fgr: offgrade
fha: offhandedness
fhe: halfheartedness
fho: leafhoppers
fhr: fhrer
fhy: selfhypnotization
fia: unclassifiableness
fib: osteochondrofibroma
fic: scientificophilosophical
fid: nonconfidentialness
fie: superultrafrostified
fif: fifteenfold
fig: semifigurativeness
fii: sufiistic
fij: fijian
fik: afikomen
fil: nonultrafilterable
fim: pectinatofimbricate
fin: infinitesimalness
fio: millefiore
fip: fippence
fiq: magnifique
fir: overaffirmativeness
fis: snailfishessnailflower
fit: nonprofitableness
fiu: superaffiuence
fiv: fivefoldness
fix: anterofixation
fiy: hanefiyeh
fiz: fizelyite
fja: fjarding
fje: fjerding
fjo: fjorded
fka: kafkaesque
fke: sofkee
fki: tscheffkinite
fkl: aufklarung
fky: gaffkya
fla: antiinflammatories
flb: flb
flc: flchette
fld: fldxt
fle: overreflectiveness
flh: niflheim
fli: nonflirtatiousness
fll: fll
fln: flnerie
flo: snailfishessnailflower
flr: flrie
flu: chlorotrifluoroethylene
fly: butterflyfishes
fma: hoffmannist
fme: enfeoffment
fmo: selfmovement
fmt: fmt
fmu: deafmuteness
fna: fname
fne: weatherproofness
fni: fefnicute
fnu: alefnull
fny: hafnyl
foa: antifoaming
fob: sulfobismuthite
foc: sulfocarbamide
fod: daffodowndillies
foe: foetalization
fof: rufoferruginous
fog: pettifogulizer
foh: sulfohydrate
foi: sulfoindigotate
fok: sofoklis
fol: cochlearifoliate
fom: sulfomethylic
fon: alkylbenzenesulfonates
foo: overfoolishness
fop: sulfophthalein
for: formaldehydesulphoxylate
fos: nonfossiliferous
fot: rufotestaceous
fou: foundationlessness
fov: desulfovibrio
fow: straightfoward
fox: dimethylsulfoxide
foy: foyaitic
foz: fozinesses
fpa: halfpaced
fpe: halfpennyworth
fph: efph
fpi: shelfpiece
fpl: fplot
fpm: fpm
fpo: roofpole
fpr: selfpreservatory
fps: offpspring
fra: archconfraternities
frd: frden
fre: freewheelingness
fri: frictionlessness
fro: superultrafrostified
frs: frsikets
frt: frt
fru: phosphofructokinase
frw: frwy
fry: undersheriffry
fsa: selfsameness
fsb: wolfsbergite
fsc: offscourings
fse: selfseekingness
fsh: undersheriffship
fsi: cliffside
fsk: razoumofskya
fsm: cliffsman
fso: liefsome
fsp: offsprings
fst: staffstriker
fsu: selfsustainingly
fta: chieftainships
ftb: softbrained
ftc: softcoal
ftd: graftdom
fte: afterfermentation
ftf: shiftfulness
ftg: koftgari
fth: softheartedness
fti: spendthriftiness
ftl: shriftlessness
ftm: coinfeftment
ftn: spendthriftness
fto: beeftongue
ftp: draftproof
ftr: halftrack
fts: handicraftsmanship
ftt: ofttimes
ftu: theftuously
ftw: aircraftwoman
fty: spendthrifty
fua: fuage
fub: fubsiest
fuc: fuchsinophilous
fud: befuddlements
fue: nonrefuelling
fuf: carfuffling
fug: ultracentrifugation
fuh: sprachgefuhl
fui: fuirdays
fuj: fujis
ful: scrofulotuberculous
fum: subfumigation
fun: defunctionalization
fur: benzofuroquinoxaline
fus: interdiffusiveness
fut: futilitarianism
fuv: effuviate
fuy: fuye
fuz: bumfuzzle
fve: arfvedsonite
fwa: gulfwards
fwd: fwd
fwe: chaffweed
fwi: undersheriffwick
fwo: beefwoods
fyc: fyces
fyd: daffydowndilly
fye: notifyee
fyf: crucifyfying
fyi: interstratifying
fyk: fykes
fyl: taffylike
fym: taffymaking
fyo: bafyot
fyr: fyrdung
fys: fortifys
fyt: fyttes
fyw: taffywise
fze: alefzero
fzi: styfziekte
gaa: meshuggaas
gab: indefatigableness
gac: supersagaciousness
gad: braggadocianism
gae: algaeological
gaf: shandygaff
gag: counterdisengagement
gah: budgereegah
gai: bougainvilliidae
gaj: megajoule
gak: megakaryoblast
gal: electrogalvanization
gam: electroamalgamation
gan: brigantinebrigantines
gao: undergaoler
gap: interzygapophysial
gar: haemogregarinidae
gas: gastroenteroanastomosis
gat: ultracentrifugation
gau: boussingaultite
gav: disgavelling
gaw: gawkishness
gay: gaylussacia
gaz: gazetteership
gba: alibangbang
gbe: youngberries
gbi: hummingbirds
gbl: bigbloom
gbo: herringbones
gbr: strongbrained
gbu: lightningbug
gby: lyngbyaceae
gca: dogcatchers
gcd: gcd
gch: thlingchadinne
gcl: longcloth
gco: ogcocephalidae
gcr: kingcraft
gcu: eggcupful
gcy: agcy
gda: pharyngoamygdalitis
gde: farthingdeal
gdi: swingdingle
gdo: amygdonitrile
gdr: plugdrawer
gds: smaragds
gdu: amygdules
gdy: igdyr
gea: noninterchangeableness
geb: nonalgebraically
gec: oophorosalpingectomy
ged: unacknowledgedness
gee: squillageeing
gef: unrevengefulness
geg: gegenschein
geh: cabbageheadedness
gei: geissolomataceous
gek: bridgekeeper
gel: pseudoevangelically
gem: counterdisengagement
gen: regeneratoryregeneratress
geo: scientificogeographical
gep: shrinkageproof
ger: counterexaggeration
ges: overgesticulativeness
get: pseudoapologetically
geu: salpingopharyngeus
gev: longevities
gew: partridgewood
gey: lammergeyer
gez: gezerah
gfa: chargfaires
gfe: dogfennel
gfi: climbingfishes
gfl: stagflation
gfo: dogfought
gfr: fogfruits
gfu: unmeaningfulness
gga: braggadocianism
ggb: eggbeaters
ggc: eggcupful
ggd: yggdrasil
gge: hypersuggestibleness
ggf: eggfruit
ggh: eggheadedness
ggi: bulldoggishness
ggl: phytohaemagglutinin
ggm: keggmiengg
ggn: luggnagg
ggo: sniggoringly
ggp: eggplants
ggr: antiaggressiveness
ggs: briggsian
ggu: waggumbura
ggw: eggwhisk
ggy: baggywrinkle
gha: stringhaltedness
ghb: unneighbourliness
ghc: roughcasting
ghd: highdaddies
ghe: strongheadedness
ghf: semithoroughfare
ghg: thoroughgoingness
ghh: roughheartedness
ghi: counterweighing
ghj: ploughjogger
ghk: throughknow
ghl: superthoroughly
ghm: boroughmongering
ghn: superthoroughness
gho: jackpuddinghood
ghp: thoroughpaced
ghr: roughrider
ghs: thoroughstitched
ght: unstraightforwardness
ghu: staghunting
ghv: highveld
ghw: superhighways
ghy: koksaghyz
ghz: maghzen
gia: bronchohemorrhagia
gib: tuberculatogibbous
gic: philosophicopsychological
gid: branchiostegidae
gie: anesthesiologies
gif: archaeopterygiformes
gig: anagignoskomena
gih: plagihedral
gii: acanthopterygii
gij: bogijiab
gik: pelargikon
gil: bronchoaspergillosis
gim: overregimentation
gin: membranocartilaginous
gio: cineangiocardiographic
gip: gipsiologist
gir: schoolgirlishness
gis: zoologicoarchaeologist
git: antiprestidigitation
giu: androgametangium
giv: gingivoglossitis
giz: demythologizations
gja: engjateigur
gje: gjetosts
gju: fylgjur
gka: menangkabau
gke: stallingken
gkh: angkhak
gki: lovingkindness
gkl: kingklip
gkn: swingknife
gko: maiongkong
gkr: neugkroschen
gla: epithelioglandular
glb: glb
gld: gld
gle: overneglectfulness
gli: cerebroganglionic
glm: ginglmi
glo: prorhipidoglossomorpha
glt: glt
glu: benzophloroglucinol
gly: phoneticohieroglyphic
gma: subdiaphragmatically
gme: superacknowledgment
gmh: megmho
gmi: pseudostalagmitical
gml: phlegmless
gmo: sphygmomanometrically
gms: diaphragms
gmt: asgmt
gmu: borborygmus
gmy: pygmyhood
gna: hyperorthognathous
gnb: signboards
gnc: ensigncies
gnd: thegndom
gne: magnetothermoelectricity
gnf: designfulness
gnh: ensignhood
gni: supermagnificently
gnl: designlessness
gnm: foredesignment
gnn: nonforeignness
gno: electrodiagnostically
gnp: signposting
gnr: ensignry
gns: sovereignship
gnt: supersovereignty
gnu: interregnums
gnw: thegnworthy
gny: iconolagny
goa: pharyngoamygdalitis
gob: pharyngobranchiate
goc: encephalomeningocele
god: myringodermatitis
goe: pharyngoepiglottidean
gof: laryngofission
gog: vagoglossopharyngeal
goh: oligohydramnios
goi: salpingopterygoid
gok: pharyngokeratosis
gol: otorhinolaryngologist
gom: zygomaticoauricularis
gon: nontrigonometrically
goo: goodtemperedness
gop: salpingoperitonitis
goq: pterygoquadrate
gor: syncategorematically
gos: bronchoesophagoscopy
got: dacryocystosyringotomy
gou: anthropophagously
gov: laryngovestibulitis
gow: stuffgownsman
gox: pharyngoxerosis
goy: gargoylishly
goz: zygozoospore
gpa: periwigpated
gpc: gpcd
gpd: gpd
gpe: tithingpenny
gph: singpho
gpi: stringpiece
gpl: gangplanks
gpm: gpm
gpo: strongpoint
gpr: preobtrudingpreobtrusion
gps: gpss
gpu: bagpudding
gqt: negqtiator
gra: electroencephalographically
grd: herrgrdsost
gre: semiprogressiveness
grf: grf
gri: transmogrifications
grn: hgrnotine
gro: barothermohygrograph
grp: incgrporate
grr: grr
grs: grs
gru: pantagruelistical
grx: grx
gry: arthrogryposis
gsa: studdingsail
gsb: kongsbergite
gsc: trackingscout
gsd: langsdorffia
gse: langsettle
gsf: bagsful
gsg: billingsgate
gsh: alongshoreman
gsi: longsightedness
gsk: frogskins
gsl: slewingslews
gsm: shoeingsmith
gsn: kingsnake
gso: longsomeness
gsp: marlingspike
gst: arsenotungstates
gsu: longsuffering
gsw: shillingsworth
gsy: langsynes
gta: tsingtauite
gtb: agtbasic
gtc: gtc
gtd: gtd
gte: langteraloo
gth: strengthlessness
gti: threshingtime
gto: neowashingtonia
gtr: bogtrotting
gtt: gtt
gtu: diminishingturns
gty: hogtying
gtz: yangtze
gua: brachiofaciolingual
gub: nonlugubriousness
guc: gucked
gud: gudebrother
gue: colleaguesmanship
guf: argufiers
gug: antiguggler
guh: kiesselguhr
gui: nondistinguishableness
guj: gujarati
guk: inguklimiut
gul: triangulotriangular
gum: overargumentativeness
gun: arosaguntacook
guo: discontiguousness
gup: growingupness
gur: semifigurativeness
gus: cephalothoracopagus
gut: gutturalisation
guv: guvacoline
guy: dentiloguy
guz: guzzledom
gva: sagvandite
gvn: mandragvn
gwa: ceilingwards
gwe: pigweabbits
gwh: slangwhang
gwi: bigwiggedness
gwo: measuringworm
gwr: songwriters
gwu: springwurzel
gwy: clogwyn
gya: magyarization
gyb: piggybacking
gyc: thiogycolic
gyd: ligydidae
gye: menologyes
gyg: cosmologygy
gyi: fogyishness
gyl: strongyloplasmata
gym: progymnospermous
gyn: gynandromorphism
gyo: gyokuro
gyp: egyptianization
gyr: cuproiodargyrite
gys: engysseismology
gyt: gytling
gyv: downgyved
gyw: baggywrinkle
gyz: koksagyz
gza: zigzaggedness
gzw: zugzwang
haa: schaapsteker
hab: nondistinguishableness
hac: craniorhachischisis
had: lymphadenectasia
hae: zoologicoarchaeologist
haf: markgenossenschaft
hag: bronchoesophagoscopy
hah: hahnemannian
hai: overthwartarchaic
haj: hajilij
hak: shakespeareanism
hal: electroencephalographically
ham: chamaepericlymenum
han: dichlorodiphenyltrichloroethane
hao: semichaotically
hap: cholecystenterorrhaphy
haq: methaqualone
har: blepharosphincterectomy
has: hastatolanceolate
hat: succinylsulphathiazole
hau: schopenhauereanism
hav: behavioristically
haw: wappenschawing
hax: kitkahaxki
hay: mahayanistic
haz: nonhazardousness
hba: switchbacker
hbe: scharlachberger
hbi: sulphbismuthite
hbl: peachblossom
hbn: exhbn
hbo: unneighbourliness
hbr: thoroughbredness
hbu: swashbucklerdom
hby: forthby
hca: scratchcarding
hcb: hcb
hcf: hcf
hch: archchronicler
hci: clistothcia
hcl: breechcloths
hco: archconfraternities
hcr: archcriminal
hcu: archcupbearer
hda: archdapifership
hdb: hdbk
hde: archdeaconries
hdi: archdiplomatist
hdk: hdkf
hdl: hdlc
hdo: archdogmatist
hdq: hdqrs
hdr: dihdroxycholecalciferol
hdu: archduchesses
hdw: hdwe
hea: dacryocystoblennorrhea
heb: hebraistically
hec: arteriosympathectomy
hed: tessarescaedecahedron
hee: freewheelingness
hef: tscheffkinite
heg: apophthegmatical
heh: blithehearted
hei: anthropomorphotheist
hej: hejazian
hek: bibliotheke
hel: lymphangioendothelioma
hem: hematospectrophotometer
hen: dichlorodiphenyltrichloroethane
heo: philosophicotheological
hep: hepaticoenterostomies
heq: cinematheques
her: magnetothermoelectricity
hes: snailfishessnailflower
het: heterotransplantation
heu: scheuchzeriaceous
hev: bolshevistically
hew: unchewableness
hex: hexahydroxycyclohexane
hey: wheyishness
hez: hematochezia
hfa: semithoroughfare
hfe: benchfellow
hfi: northfieldite
hfl: archflatterer
hfo: thoroughfooting
hfr: archfriend
hfs: shfsep
hfu: unreproachfulness
hga: throughganging
hge: archgenethliac
hgi: mashgichim
hgl: watchglassful
hgm: apothgm
hgo: thoroughgoingness
hgr: thoroughgrowth
hgt: hgt
hgu: healthguard
hgw: hgwy
hha: highhandedness
hhd: hhd
hhe: roughheartedness
hhi: hitchhikers
hho: unwithholding
hhu: archhumbug
hhy: archhypocrisy
hia: macracanthrorhynchiasis
hib: labyrinthibranchiate
hic: electroencephalographically
hid: brachiorrhachidian
hie: phoneticohieroglyphic
hif: hesperornithiformes
hig: allothigenetically
hih: archiheretical
hii: labyrinthibranchii
hij: hijackings
hik: mishikhwutmetunne
hil: philosophicopsychological
him: archimperialistic
hin: blepharosphincterectomy
hio: brachiofaciolingual
hip: prorhipidoglossomorpha
hiq: armouchiquois
hir: anatomicochirurgical
his: pathologicohistological
hit: anthropomorphitical
hiu: actinotrichium
hiv: superchivalrousness
hiw: sahiwals
hix: thixolabile
hiy: hiyakkin
hiz: deanthropomorphization
hja: highjacking
hje: trondhjemite
hji: shohjis
hjn: brainwashjng
hjo: ploughjogger
hka: babushkas
hke: sabbathkeeping
hkf: chkfile
hkh: tahkhana
hki: kitkehahki
hkn: throughknow
hko: shkotzim
hku: shkupetar
hky: droshky
hla: chlamydobacteriaceous
hlb: fahlbands
hld: hld
hle: phlebarteriodialysis
hlh: stahlhelmist
hli: encephalothlipsis
hll: hushllsost
hlo: dichlorodiphenyltrichloroethane
hlq: hlqn
hlr: kohlrabies
hls: mahlstick
hlt: tahltan
hlu: bremsstrahlung
hlw: buhlworks
hly: pseudoamateurishly
hma: nonasthmatically
hme: antidisestablishmentarianism
hmg: vehmgericht
hmi: autopsychorhythmia
hml: rhythmless
hmm: microhmmeter
hmn: knorhmn
hmo: ethmopresphenoidal
hmp: rhythmproof
hms: antilogarithms
hmu: archmurderer
hmy: archmystagogue
hna: splanchnapophysial
hnb: johnboats
hnd: lahnda
hne: schoolmasterishness
hnf: ahnfeltia
hnh: houyhnhnm
hni: countertechnicality
hnk: krohnkite
hnl: foehnlike
hnm: houyhnhnm
hnn: johnnycake
hno: ethnomusicologically
hns: johnsonianism
hnu: sporochnus
hny: mataeotechny
hoa: nonpsychoanalytically
hob: ornithobiographical
hoc: hypsidolichocephalism
hod: choledochoduodenostomy
hoe: choledochoenterostomy
hof: phosphofructokinase
hog: chromophotolithograph
hoh: bronchohemorrhagia
hoi: anarchoindividualist
hoj: bhojpuri
hok: agathokakological
hol: philosophicopsychological
hom: homeotransplantation
hon: phenolsulphonephthalein
hoo: schoolmasterishness
hop: psychopharmacological
hoq: psychoquackeries
hor: immunoelectrophoretically
hos: phosphoglyceraldehyde
hot: microspectrophotometrically
hou: hypocraterimorphous
hov: orthoveratraldehyde
how: chowderheadedness
hox: formaldehydesulphoxylate
hoy: hobbledehoyishness
hoz: trapezophozophora
hpa: lymhpangiophlebitis
hpe: catchpennies
hph: archphilosopher
hpi: unmouthpieced
hpl: archplagiarist
hpo: archpolitician
hpr: archpresbyterate
hps: mphps
hpt: shpt
hpu: archpublican
hqu: preearthquake
hra: dimethylanthranilate
hrb: lehrbachite
hrd: mehrdad
hre: benzoxyphenanthrene
hri: ureteropyelonephritis
hrl: wehrlite
hrm: heathrman
hro: anthropomorphologically
hrr: shrrinkng
hrs: cyclarthrsis
hru: undershrubbiness
hrw: ehrwaldite
hry: blepharophryplasty
hrz: yahrzeits
hsa: archsacrificator
hsc: archscoundrel
hsd: friedrichsdor
hse: breathseller
hsg: reichsgulden
hsh: earthshattering
hsi: fuchsinophilous
hsk: rathskellers
hsl: reichslander
hsm: coachsmithing
hsn: archsnob
hso: unhealthsomeness
hsp: reichspfennig
hst: thoroughstitched
hsu: mahsur
hsw: archswindler
hsy: archsynagogue
hta: breathtakingly
htb: mynpachtbrief
htc: nightcrawlers
htd: nightdress
hte: superrighteousness
htf: unstraightforwardness
htg: nightglass
hth: tetraiodophenolphthalein
hti: dactylioglyphtic
htj: straightjacket
htk: lightkeeper
htl: forethoughtless
htm: lightmindedness
htn: overstraightness
hto: oxynaphtoquinone
htp: machtpolitik
htr: archtreasurership
hts: draughtswomanship
htt: straighttail
htu: taltushtuntude
htv: eightvos
htw: sightworthiness
hty: mightyhearted
hua: protocatechualdehyde
hub: hubristically
huc: chuckleheadedness
hud: hudibrastically
hue: huelessness
huf: shuffleboard
hug: huggermuggery
huh: shuhali
hui: anthropophuistic
huj: isothujone
huk: bathukolpian
hul: scrophulariaceous
hum: humuhumunukunukuapuaa
hun: philosophunculist
huo: xiphuous
hup: chuprassie
hur: hydrodesulphurization
hus: pseudoenthusiastically
hut: hutchinsonianism
huu: chuumnapm
huv: bahuvrihis
hux: huxleian
huy: ahantchuyuk
huz: huzvaresh
hva: archvagabond
hve: archvestryman
hvh: jhvh
hvi: zilchviticetum
hvr: ornithvrous
hvy: hvy
hwa: overthwartarchaic
hwe: westnorthwestwardly
hwh: worthwhileness
hwi: tableclothwise
hwo: unfaithworthiness
hwr: ploughwright
hwt: hwt
hwu: mishikhwutmetunne
hwy: morthwyrtha
hya: hyalinocrystalline
hyb: autohybridization
hyc: hypsibrachycephalism
hyd: hydroxydehydrocorticosterone
hye: hyetometrographic
hyf: brachyfacial
hyg: sphygmomanometrically
hyh: bathyhyperesthesia
hyi: epigonichthyidae
hyk: hyke
hyl: cyclotrimethylenetrinitramine
hym: thymolsulphonephthalein
hyn: macracanthrorhynchiasis
hyo: ichthyopaleontology
hyp: hyperconscientiousness
hyr: thyroparathyroidectomize
hys: anatomicophysiological
hyt: phytopaleontological
hyu: stachyuraceous
hyv: pachyvaginitis
hyw: trophywort
hyx: autoasphyxiation
hyy: leeshyy
hyz: diphyzooid
hza: shahzadah
hze: scheuchzeriaceous
hzo: machzorim
hzy: barukhzy
iaa: baviaantje
iab: circumstantiability
iac: chlamydobacteriaceous
iad: antiadministration
iae: antimediaevalism
iaf: semiaffectionate
iag: electrodiagnostically
iah: diaheliotropically
iai: antiaircraft
iaj: biajaiba
iak: triakisicosahedral
ial: antimaterialistically
iam: counterpronunciamento
ian: antidisestablishmentarianism
iao: periaortitis
iap: subdiaphragmatically
iaq: antiaquatic
iar: antiaristocratically
ias: macracanthrorhynchiasis
iat: pseudolamellibranchiata
iau: antiauthoritarianism
iav: machiavellianism
iaw: hiawatha
iax: multiaxially
iaz: succinylsulphathiazole
iba: noncannibalistically
ibb: tuberculatogibbous
ibc: squibcrack
ibd: fibdom
ibe: uncircumscribedness
ibg: ribgrasses
ibh: avyayibhava
ibi: hypersuggestibility
ibk: libken
ibl: superincomprehensibleness
ibm: jibman
ibn: nondefeasibness
ibo: desoxyribonucleoprotein
ibr: pseudolamellibranchiata
ibs: corncribs
ibu: mandibulosuspensorial
ibw: cribworks
iby: libytheidae
ibz: ribzuba
ica: electroencephalographically
icb: tropicbird
icc: electrodesiccation
icd: magicdom
ice: superserviceableness
icf: frolicful
icg: gynecicgynecidal
ich: dichlorodiphenyltrichloroethane
ici: magnetothermoelectricity
ick: chickenheartedness
icl: archicleistogamous
icm: panicmongering
icn: chemotherapeuticness
ico: hydroxydehydrocorticosterone
icp: peroxidicperoxiding
icq: chicquest
icr: microspectrophotometrically
ics: magnetofluidmechanics
ict: uncontradictableness
icu: pneumoventriculography
icw: arcticwards
icy: dicyclopentadienyliron
icz: ziczac
ida: chlorprophenpyridamine
idb: midbrains
idc: midchannel
idd: magnetofluiddynamics
ide: thyroparathyroidectomize
idf: midforenoon
idg: partridgeberries
idh: stupidheaded
idi: antidisestablishmentarianism
idj: feridjee
idk: maidkin
idl: pseudoinvalidly
idm: magnetofluidmechanics
idn: subpellucidness
ido: prorhipidoglossomorpha
idp: midparentage
idr: blepharochromidrosis
ids: corticosteroids
idt: doublewidth
idu: overindividualistically
idv: midventral
idw: midwesterners
idy: epididymodeferentectomy
idz: phloridzin
iea: propionibacterieae
ieb: liebfraumilch
iec: antiecclesiastically
ied: superultrafrostified
iee: trieennia
ief: handkerchiefful
ieg: antiegotistically
ieh: mouchrabieh
iei: asclepieion
iej: antiejaculation
iek: shriekiness
iel: actinodielectric
iem: antiempirically
ien: scientificophilosophical
iep: archiepiscopality
ieq: milliequivalent
ier: phoneticohieroglyphic
ies: counterrevolutionaries
iet: phenyldiethanolamine
ieu: underlieutenant
iev: superbelievableness
iew: interviewable
iex: antiexpressionistic
iey: antieyestrain
iez: piezocrystallization
ifa: multifactorially
ifb: gifblaar
ifd: difda
ife: dihdroxycholecalciferol
iff: interdifferentiating
ifi: scientificophilosophical
ifl: chlorotrifluoroethylene
ifn: hastifness
ifo: archaeopterygiformes
ifr: congelifraction
ifs: leitmotifs
ift: spendthriftiness
ifu: ultracentrifugation
ify: interstratifying
iga: brigantinebrigantines
igb: bigbloom
igd: igdrasil
ige: counterintelligence
igf: pigfishes
igg: thimbleriggery
igh: unstraightforwardness
igi: philosophicoreligious
igl: pharyngoepiglottidean
igm: ureterosigmoidostomy
ign: nonignominiousness
igo: indigotindisulphonic
igp: periwigpated
igr: antigrammaticalness
igs: pigsticking
igt: bigthatch
igu: semifigurativeness
igw: bigwiggedness
igy: multigyrate
igz: zigzaggedness
iha: antiharmonist
ihd: dihdroxycholecalciferol
ihe: trihemitetartemorion
ihf: chihfu
ihi: annihilationistical
ihl: schlemihl
ihn: palaihnihan
iho: superlikelihood
ihp: ihp
ihr: ihrams
ihs: shantihs
iht: teihte
ihu: semihumanitarian
ihy: dihydrostreptomycin
iia: condominiia
iic: foliicolous
iid: anthracotheriidae
iie: galleriies
iif: procellariiformes
iii: xviii
iik: wiikite
iil: waiilatpuan
iim: quinonediimine
iin: antiinstitutionalists
iio: triiodothyronine
iip: diipenates
iis: diisatogen
iit: manganostibiite
iiu: condominiiums
iiw: iiwi
iiz: albumeniizer
ija: azerbaijanese
ijb: indijbiously
ijd: infeijdation
ije: jeewhillijers
ijh: nijholt
iji: kharijite
ijj: zulhijjah
ijk: rijksdaalder
ijl: mijl
ijm: ijmaa
ijn: mijnheerl
ijo: semijocularly
ijr: hijra
iju: semijuridically
ijv: blijver
ijw: bijwoner
ika: transbaikalian
ikd: sheikdoms
ike: ungentlemanlikeness
ikh: mishikhwutmetunne
iki: micropoikilitic
ikk: geeldikkop
ikl: epikleses
ikn: camiknickers
iko: hypokoristikon
ikr: bromopikrin
iks: apparatchiks
ikt: varnpliktige
iku: alikulufan
ikv: hatikvah
ikw: haikwan
iky: polygynaiky
ikz: malikzadi
ila: pseudophilanthropically
ilb: diethylstilboestrol
ilc: zilchviticetum
ild: overchildishness
ile: pseudosacrilegiously
ilf: snailfishessnailflower
ilg: pilgrimatical
ilh: silhouettograph
ili: intertransformability
ilj: miljee
ilk: milksoppishness
ill: bronchoaspergillosis
ilm: disembroilment
iln: unpredictabilness
ilo: philosophicopsychological
ilp: stilpnosiderite
ilq: milquetoasts
ilr: prerailroadite
ils: countervails
ilt: nonultrafilterable
ilu: chemiluminescence
ilv: quicksilverishness
ilw: antirailwayist
ily: sulfanilylguanidine
ilz: capercailzie
ima: anthropoclimatologist
imb: pectinatofimbricate
imc: cimcumvention
imd: pilgrimdom
ime: cyclotrimethylenetrinitramine
imf: brimfullness
img: grimgribber
imh: paynimhood
imi: antimilitaristically
imj: jimjams
imk: reimkennar
iml: unpilgrimlike
imm: immunoelectrophoretically
imn: limnobiologically
imo: nonsanctimoniousness
imp: overimpressionableness
imr: primrosetide
ims: unwhimsicalness
imt: leimtype
imu: overstimulativeness
imv: quindecimvir
imw: aimworthiness
imy: antimysticalness
imz: mimzy
ina: interdenominationalism
inb: sponginblastic
inc: superincomprehensibleness
ind: overindividualistically
ine: cyclotrimethylenetrinitramine
inf: preinferredpreinferring
ing: preobtrudingpreobtrusion
inh: noninheritableness
ini: cyclotrimethylenetrinitramine
inj: noninjuriousness
ink: intersprinkling
inl: finlandization
inm: nonascertainment
inn: antitintinnabularian
ino: aminoacetophenetidine
inp: azinphosmethyl
inq: superinquisitiveness
inr: chamberlainry
ins: deinstitutionalization
int: pseudointernationalistic
inu: spinulosodenticulate
inv: counterinvestment
inw: mountainwards
inx: archocystosyrinx
iny: succinylsulphathiazole
inz: zinziberaceous
ioa: bacterioagglutinin
iob: biobibliographical
ioc: cineangiocardiographic
iod: tetraiodophenolphthalein
ioe: lymphangioendothelioma
iof: brachiofaciolingual
iog: electrocardiographically
ioh: ovariohysterectomy
ioi: scleroticochorioiditis
ioj: subclaviojugular
iok: bibliokleptomaniac
iol: anatomicophysiological
iom: pericardiomediastinitis
ion: preobtrudingpreobtrusion
ioo: perioophoritis
iop: glossolabiopharyngeal
ioq: stultioquy
ior: neurochorioretinitis
ios: arteriosympathectomy
iot: poluphloisboiotatotic
iou: hyperconscientiousness
iov: stapediovestibular
iow: demiowl
iox: benzdioxtriazine
ioy: anterioyancer
ioz: ascidiozooid
ipa: antiparliamentarians
ipb: shipbreaking
ipc: whipcracker
ipd: gossipdom
ipe: pseudoerysipelatous
ipf: worshipfulness
ipg: slipgibbet
iph: dichlorodiphenyltrichloroethane
ipi: prorhipidoglossomorpha
ipj: skipjackly
ipk: shipkeeper
ipl: preterdiplomatically
ipm: gossipmongering
ipn: semipneumatically
ipo: plenipotentiaryship
ipp: hippocastanaceous
ipr: antiprestidigitation
ips: cholecystolithotripsy
ipt: orbiculatoelliptical
ipu: micromanipulation
ipw: shipwrightery
ipy: peripylephlebitis
ipz: leipzig
iqa: tariqat
iqh: fiqh
iqr: miqra
iqs: iqs
iqu: hemidemisemiquaver
ira: hypermiraculousness
irb: stairbuilding
irc: circumparallelogram
ird: countergirded
ire: omnirepresentativeness
irf: despairfulness
irg: devirgination
irh: semirhythmically
iri: hyperspiritualizing
irj: girja
irk: pitmenpitmirk
irl: schoolgirlishness
irm: overaffirmativeness
irn: firnification
iro: dicyclopentadienyliron
irp: inextirpableness
irq: quirquincho
irr: irreconciliableness
irs: bloodthirstiness
irt: nonflirtatiousness
iru: anatomicochirurgical
irv: clairvoyancies
irw: airworthiness
iry: countervairy
irz: mirzas
isa: transcendentalisation
isb: poluphloisboiotatotic
isc: overdiscriminatingly
isd: disdenominationalize
ise: antidisestablishmentarianism
isf: dissatisfactoriness
isg: disgracefulness
ish: antidisestablishmentarianism
isi: superinquisitiveness
isj: nondisjunctional
isk: triskaidekaphobes
isl: counterlegislation
ism: antidisestablishmentarianism
isn: disnaturalization
iso: isopropylideneacetone
isp: disproportionableness
isq: disqualifications
isr: premisrepresentation
iss: counterreconnaissance
ist: pseudointernationalistic
isu: antisupernaturalistic
isv: disvulnerability
isw: praisworthiness
isy: axisymmetrically
isz: miszealous
ita: antiauthoritarianism
itb: distritbuting
itc: featherstitching
itd: spiritdom
ite: transubstantiationite
itf: overfruitfulness
itg: fruitgrowing
ith: cholecystolithotripsy
iti: pericardiomediastinitis
itj: straitjacket
itk: kitkahaxki
itl: straitlacedness
itm: counterfeitment
itn: counterfeitness
ito: peritoneopericardial
itp: agitpropist
itr: cyclotrimethylenetrinitramine
its: mitsukurinidae
itt: nonintermittentness
itu: deinstitutionalization
itv: mitvoth
itw: antitwilight
ity: magnetothermoelectricity
itz: politzerization
iua: antiuating
iub: cupiuba
iuc: bacchiuchii
iud: ciudad
iue: superaffiuence
iug: collegiugia
iuj: jiujitsus
iuk: liukiu
iul: endotheliulia
ium: hydropneumopericardium
iun: vibratiunculation
iup: mariupolite
iuq: ololiuqui
iur: acetylenediurein
ius: ichthyophthirius
iut: antiutilitarianism
iuu: residiuum
iuv: periuvular
iva: superchivalrousness
ivd: vivda
ive: omnirepresentativeness
ivi: overindividualistically
ivl: capacitativly
ivn: grivna
ivo: subjectivoidealistic
ivr: livraison
ivs: isogrivs
ivt: mesivta
ivu: rivulariaceous
ivv: chivvying
ivw: chivw
ivy: ivyberries
ivz: shivzoku
iwa: antiwarlike
iwb: iwbells
iwe: attiwendaronk
iwf: iwflower
iwh: porokaiwhiria
iwi: beperiwigged
iwo: multiwords
iwu: iwurthen
iww: iwwood
iwy: skiwy
ixa: anterofixation
ixb: bixbyite
ixd: rixdaler
ixe: antixerophthalmic
ixf: sixfolds
ixg: fixgig
ixh: sixhaend
ixi: nonlixiviation
ixl: overprolixly
ixm: suffixment
ixn: overprolixness
ixo: hypermixolydian
ixp: sixpennyworth
ixs: executrixship
ixt: intermixtures
ixu: fixures
ixw: flixweed
ixy: epixylous
iya: pratiyasamutpada
iye: semiyearlies
iyi: saiyids
iyn: butadiyne
iyo: aliyoth
iyu: seiyuhonto
iza: overintellectualization
izb: whizbangs
izc: neumatizce
izd: samizdat
ize: thyroparathyroidectomize
izg: fizgigs
izi: overintellectualizing
izk: yizkor
izl: aizle
izm: transcendentalizm
izn: biznagas
izo: epizootiologically
izp: mizpah
izr: mizrach
izs: vizslas
izt: schiztic
izu: pachyrhizus
izv: izvozchik
izw: tizwin
izy: antizymotic
izz: quizzification
jaa: bobbejaan
jab: jabberwockian
jac: interjaculateded
jad: arrojadite
jae: stolkjaerre
jag: jaguarundis
jah: hallelujahs
jai: jailbreaker
jaj: pindjajap
jak: jogjakarta
jal: hlidhskjalf
jam: clamjamphrie
jan: azerbaijanese
jao: cacajao
jap: japaconitine
jaq: jaqueline
jar: ammoniojarosite
jas: jasminaceae
jat: jatrorrhizine
jau: jaundiceroot
jav: javelineer
jaw: jawbreakingly
jax: ajax
jay: huantajayite
jaz: jazziness
jba: rajbansi
jbi: indijbiously
jcl: jcl
jct: jctn
jda: infeijdation
jdi: nejdi
jds: slojds
jea: overjealousness
jeb: jebusitical
jec: subjectivoidealistic
jed: jedburgh
jee: jeewhillijers
jef: jeffersonianism
jeg: conjegates
jeh: jehoshaphat
jei: yajeine
jej: cholecystojejunostomy
jek: jekyll
jel: kjeldahlization
jem: trondhjemite
jen: antejentacular
jeo: jeopardousness
jep: katjepiering
jeq: jequirities
jer: jeewhillijers
jes: majesticalness
jet: jettisonable
jeu: dejeuners
jev: jeremejevite
jew: bejewelling
jex: senijextee
jez: jezebelian
jge: jger
jha: jharal
jhe: jheel
jho: nijholt
jhu: jhuria
jhv: jhvh
jia: bogijiab
jib: djibouti
jic: projiciently
jid: cucujidae
jie: geitjie
jif: jiffies
jig: thingumajigger
jih: jihads
jik: crojiks
jil: tasajillos
jim: jimberjawed
jin: jingoistically
jip: jipijapas
jiq: jiqui
jir: guajiras
jis: munjistin
jit: jitterbugging
jiu: jiujitsus
jiv: jivaroan
jix: jixie
jiz: jizyah
jja: zulhijjah
jje: hajjes
jji: hajjis
jki: pirojki
jks: rijksdaalder
jli: majlis
jlk: getmjlkost
jma: jajman
jms: jms
jna: yajnavalkya
jnd: jnd
jng: brainwashjng
jnh: mijnheerl
jno: yajnopavita
jnt: jnt
joa: joachimite
job: jobbernowlism
joc: overjocularity
jod: jodhpurs
joe: banjoes
jof: aljofaina
jog: ploughjogger
joh: johannisberger
joi: disjointedness
joj: jojobas
jok: jokesomeness
jol: jolterheadedness
jom: sjomila
jon: jonathanization
joo: jookerie
jop: thujopsis
jor: majoritarianism
jos: josephinism
jot: jotunnheim
jou: nonjournalistically
jov: jovicentrically
jow: jowliest
joy: unenjoyableness
joz: vejoz
jpo: rajpoot
jpu: bhojpuri
jra: maharajrana
jre: bajree
jri: bajri
jsc: objscan
jta: mujtahid
jua: guanajuatite
jub: jubilization
juc: injucundity
jud: nonadjudicatively
jue: matajuelo
juf: juffer
jug: pseudoconjugation
juh: juha
jui: juicelessness
juj: jujitsus
juk: jukeboxes
jul: tapijulapane
jum: counterjumper
jun: blepharoconjunctivitis
jup: cajuputene
jur: philosophicojuristic
jus: superjustification
jut: coadjutorship
juv: semperjuvenescent
juw: juwise
jux: juxtaterrestrial
juy: juyas
juz: juza
jve: blijver
jwa: jwahar
jwo: bijwoner
jyl: thujyl
jym: jymold
jyn: jynginae
kaa: kaataplectic
kab: unattackableness
kac: backaching
kad: lackadaisicalness
kae: hecctkaerre
kaf: kaffeeklatsch
kag: shrinkageproof
kah: alkahestical
kai: tetrakaidecahedron
kaj: crackajack
kak: agathokakological
kal: kaleidoscopically
kam: ekamanganese
kan: afrikanderdom
kao: kaolinisation
kap: triskaidekaphobes
kar: karyosystematics
kas: jackassification
kat: overtalkativeness
kau: suckauhock
kav: shtokavski
kaw: chuckawalla
kax: pickaxing
kay: sambhogakaya
kaz: kazatskies
kba: blackballing
kbe: blackberrylike
kbi: bookbinderies
kbl: backblocks
kbn: bkbndr
kbo: backbonelessness
kbp: kbps
kbr: crackbrainedness
kbu: blockbusters
kca: crankcases
kch: chackchiuma
kci: dickcissel
kcl: sackclothed
kco: backcourtman
kcr: cockcrowing
kcu: blackcurrant
kcy: bkcy
kda: backdating
kde: bookdealer
kdi: clackdish
kdo: sockdolager
kdr: sneckdrawing
kea: unlikeableness
keb: brackebuschite
kec: chokecherries
ked: counterattacked
kee: housekeeperlike
kef: smokefarthings
keg: keggmiengg
keh: rakehellish
kei: hypokeimenometry
kej: smokejumper
kek: alkekengi
kel: helterskelteriness
kem: likemindedness
ken: ungentlemanlikeness
keo: keogenesis
kep: overskepticalness
ker: keratoconjunctivitis
kes: shakespeareanism
ket: dimethyldiketone
keu: skeuomorphic
kev: barkevikitic
kew: likewiseness
kex: kexes
key: monkeyishness
kfa: breakfastless
kfe: schwenkfeldian
kfi: crookfingered
kfl: backflowing
kfo: frankforter
kfr: blackfriars
kfu: superthankfulness
kga: backgammon
kgd: bkgd
kge: markgenossenschaft
kgf: kgf
kgi: workgirl
kgo: ginkgoaceous
kgr: backgrounds
kgs: pkgs
kgu: blackguardism
kha: backhandedness
khd: sheikhdom
khe: blackheartedness
khi: mekhitarist
khl: sheikhlike
khm: subakhmimic
khn: dukhn
kho: stackhousiaceous
khp: pakhpuluk
khr: khrushchev
khs: hekhsherim
kht: bakhtiari
khu: duckhunting
khv: khvat
khw: mishikhwutmetunne
khy: akhyana
khz: barukhzy
kia: czechoslovakians
kib: kibblerman
kic: autarkically
kid: kidderminster
kie: holluschickie
kif: turkification
kih: gawkihood
kii: waterskiing
kij: skijorers
kik: autarkikal
kil: micropoikilitic
kim: shikimotoxin
kin: kinematographically
kio: threskiornithidae
kip: nonskipping
kir: outskirmisher
kis: dyakisdodecahedron
kit: pseudobrookite
kiu: pollakiuria
kiv: skiverwood
kiw: awikiwiki
kiy: shaikiyeh
kiz: dockization
kja: blackjacking
kje: kjeldahlization
kjo: stockjobbery
kju: stockjudging
kka: steekkannen
kke: subbookkeeper
kkh: dukkha
kki: brickkiln
kkl: brekkle
kkn: knickknackatory
kko: geeldikkop
kku: ishshakku
kky: brekky
kla: kaffeeklatsch
kle: bibliokleptomaniac
kli: hydrofranklinite
kln: kln
klo: folkloristic
klr: bklr
klu: lacklusterness
klv: klva
kly: mountebankly
kma: workmanlikeness
kme: disembarkment
kmi: blankmindedness
kmo: bookmobiles
kmu: clockmutch
kmv: maskmv
kna: knickknackatory
kne: cockneyfication
kng: shrrinkng
kni: knickerbockered
kno: disacknowledgements
knu: knuckleheadedness
kny: knyazi
koa: sanyakoan
kob: microleukoblast
koc: hyperleukocytosis
kod: tokodynamometer
koe: koeberliniaceous
kof: checkoffs
kog: koggelmannetje
koh: kohlrabies
koi: koilanaglyphic
koj: kojang
kok: adiadokokinesia
kol: agathokakological
kom: anagignoskomena
kon: counterreckoning
koo: cuckooflower
kop: panleukopenia
kor: kakorraphiaphobia
kos: chalkosideric
kot: episkotister
kou: ampherotokous
kov: kalashnikov
kow: flockowner
kox: alkoxide
koy: koyemshi
koz: yokozunas
kpa: backpackers
kpc: kpc
kpe: backpedaling
kph: ekphorias
kpi: stockpiling
kpl: sparkplugging
kpo: crackpottedness
kpr: shriekproof
kpt: bkpt
kpu: jackpuddinghood
kqu: cuckquean
kra: krameriaceous
kre: kremlinologists
kri: sanskritization
krk: mikrkra
krn: krna
kro: hypermakroskelic
krs: dhikrs
krt: akrteria
kru: pseudobankrupt
kry: kryptocyanine
krz: krzysztof
ksa: packsaddles
ksb: storksbill
ksc: backscattering
ksd: rijksdaalder
kse: booksellerish
ksf: cocksfoot
ksg: thanksgivings
ksh: crookshouldered
ksi: quicksilverishness
ksk: thickskulled
ksl: backslidingness
ksm: blacksmithing
ksn: pecksniffianism
kso: milksoppishness
ksp: backspacefile
ksr: volksraad
kst: backstitching
ksu: checksumming
ksv: clarksville
ksw: backswordsman
ksy: tricksy
kta: cocktailing
kte: backtender
ktg: mktg
kth: breakthroughes
kti: microtektite
kto: ektodynamorphic
ktr: backtrackers
kts: tsktsking
ktt: corvktte
ktu: frakturs
ktw: gedecktwork
kty: diktyonite
ktz: dashnaktzutiun
kua: humuhumunukunukuapuaa
kub: kubuklion
kuc: streuselkuchen
kud: nikkudim
kue: kuehneola
kuf: kuffieh
kug: kugelhof
kuh: lieberkuhn
kui: kuichua
kuj: kujawiak
kuk: bikukulla
kul: numskulledness
kum: doppelkummel
kun: humuhumunukunukuapuaa
kuo: kuomintang
kup: kupfernickel
kur: mitsukurinidae
kus: kuskwogmiut
kut: skutterudite
kuv: kuvaszok
kuw: kuwait
kuy: kikuyu
kva: folkvangr
kve: backvelder
kvi: kalkvis
kvo: mikvoth
kvu: kvutzah
kwa: candlestickward
kwe: checkweighman
kwh: buckwheatlike
kwi: counterclockwise
kwo: thankworthiness
kwr: checkwriter
kwu: knackwursts
kwy: pkwy
kxi: kickxia
kya: kosteletzkya
kyb: stickybeak
kyc: skycoach
kyd: flunkydom
kye: marrowskyer
kyf: stinkyfoot
kyh: flunkyhood
kyi: flunkyistic
kyj: skyjackers
kyk: kyklopes
kyl: alkylbenzenesulfonates
kym: kymographic
kyn: kynurenic
kyo: cockyolly
kyp: kyphoscoliosis
kyr: stethokyrtograph
kys: smokyseeming
kyt: honkytonks
kyu: wanyakyusa
kyw: skywriters
kza: malikzadi
laa: balaamitical
lab: glossolabiopharyngeal
lac: calcareoargillaceous
lad: helminthocladiaceae
lae: palaeodendrologically
laf: spongillaflies
lag: membranocartilaginous
lah: lootiewallah
lai: irreclaimableness
laj: flajolotite
lak: leucoplakial
lal: erythremomelalgia
lam: diphenylaminechlorarsine
lan: pseudophilanthropically
lao: laodiceanism
lap: laparocolpohysterotomy
laq: violaquercitrin
lar: otorhinolaryngologist
las: counterclassifications
lat: formaldehydesulphoxylate
lau: superplausibleness
lav: tracheloclavicular
law: lawabidingness
lax: pseudoanaphylaxis
lay: photoplaywright
laz: benzophthalazine
lba: wheelbarrowful
lbe: alkylbenzenesulfonates
lbf: lbf
lbi: albigensianism
lbl: gallbladders
lbo: diethylstilboestrol
lbr: kilbrickenite
lbs: flashbulbs
lbu: gastroalbuminorrhea
lbw: lbw
lby: bielby
lca: acetylmethylcarbinol
lcd: lcd
lce: ulceromembranous
lcg: folcgemot
lch: demethylchlortetracycline
lci: dihdroxycholecalciferol
lck: talcking
lcl: androclclinia
lcm: alcmene
lco: chromochalcographic
lcr: musselcracker
lcs: calcsinter
lct: chemoprophyalctic
lcu: incalculableness
lcw: wilcweme
lcy: benzalcyanhydrin
lda: kjeldahlization
ldb: coldbloodedness
ldc: childcrowing
ldd: shielddrake
lde: formaldehydesulphoxylate
ldf: auldfarrantlike
ldg: waldgravine
ldh: boldheartedness
ldi: phenyldiethanolamine
ldk: childkind
ldl: otherworldliness
ldm: withholdment
ldn: otherworldness
ldo: hyperaldosteronism
ldp: baldpatedness
ldq: worldquake
ldr: schoolchildren
lds: feldspathization
ldt: humboldtilite
ldu: skullduggeries
ldw: worldwideness
ldx: fldxt
ldy: goldylocks
lea: triacetyloleandomycin
leb: phlebarteriodialysis
lec: electroencephalographically
led: choledochoduodenostomy
lee: eleemosynariness
lef: tablefellowship
leg: phototelegraphically
leh: telehydrobarometer
lei: tetraiodophenolphthalein
lej: jinglejangle
lek: telekinematography
lel: parallelogrammatical
lem: hypercholesterolemia
len: cyclotrimethylenetrinitramine
leo: desoxyribonucleoprotein
lep: blepharosphincterectomy
leq: harlequinesque
ler: scleroticochorioiditis
les: antiecclesiastically
let: electrotelethermometer
leu: ophthalmoleucoscope
lev: levelheadedness
lew: gentlewomanliness
lex: unlexicographically
ley: countervolley
lez: melezitase
lfa: phthalylsulfathiazole
lfb: wolfberries
lfc: unselfconsciousness
lfd: calfdozer
lfe: schoolfellowship
lff: selffulness
lfg: palfgeys
lfh: selfhypnotization
lfi: snailfishessnailflower
lfk: calfkill
lfl: snailfishessnailflower
lfm: selfmovement
lfn: halfnesses
lfo: alkylbenzenesulfonates
lfp: selfpreservatory
lfr: nonselfregarding
lfs: selfsustainingly
lft: twelfthtide
lfu: hydrodesulfurization
lfw: gulfwards
lfy: fosslfying
lga: electroamalgamation
lge: neuroleptoanalgesia
lgh: neelghan
lgi: erythremomelalgia
lgj: fylgjur
lgl: arsenophenylglycin
lgo: algoesthesiometer
lgr: fullgrownness
lgt: lgth
lgu: sulfanilylguanidine
lgy: cephalalgy
lha: aeolharmonica
lhb: lhb
lhd: lhd
lhe: levelheadedness
lhi: philhippic
lho: silhouettograph
lhu: illhumored
lhy: dinitrophenylhydrazine
lia: antiparliamentarians
lib: pseudolamellibranchiata
lic: formaldehydesulphoxylic
lid: isopropylideneacetone
lie: poliencephalomyelitis
lif: impossibilification
lig: philosophicoreligious
lih: superlikelihood
lii: bougainvilliidae
lij: jeewhillijers
lik: ungentlemanlikeness
lil: soliloquisingly
lim: anthropoclimatologist
lin: demethylchlortetracycline
lio: lymphangioendothelioma
lip: orbiculatoelliptical
liq: colliquativeness
lir: dicyclopentadienyliron
lis: antidisestablishmentarianism
lit: polioencephalomyelitis
liu: neuroepithelium
liv: semiobliviousness
liw: friendliwise
lix: nonlixiviation
liy: aliyahaliyahs
liz: overintellectualization
lja: gimbaljawed
lje: miljee
lji: billjim
ljo: copaljocote
lju: seljukian
lka: overtalkativeness
lkb: chalkboards
lkc: chalkcutter
lkd: elkdom
lke: kestrelkestrels
lkf: milkfishes
lkg: silkgrower
lkh: bulkheading
lki: overbulkiness
lkj: stolkjaerre
lkk: kolkka
lkl: folkloristic
lkm: folkmooter
lkn: wellknown
lko: chalkosideric
lkp: chalkpit
lkr: chalkrail
lks: milksoppishness
lkt: folktales
lku: streuselkuchen
lkv: folkvangr
lkw: chalkworker
lky: alkylbenzenesulfonates
lla: hyperpolysyllabically
llb: gallbladders
llc: wellconnected
lld: bulldoggishness
lle: overintellectualization
llf: shellfisheries
llg: fullgrownness
llh: swellheadedness
lli: pseudolamellibranchiata
llj: killjoys
llk: stallkeeper
lll: bimilllennia
llm: superfulfillment
lln: resentfullness
llo: crystalloluminescence
llp: wallpapering
llq: wellqueme
llr: bullragging
lls: gesellschaften
llt: belltopperdom
llu: electrometallurgical
llv: cellvibrio
llw: millwrighting
lly: electroencephalographically
lma: phenylethylmalonylurea
lmb: holmberry
lmc: palmchrist
lmd: filmdoms
lme: trinitrophenylmethylnitramine
lmf: palmful
lmg: filmgoers
lmh: helmholtzian
lmi: helminthocladiaceae
lml: filmlands
lmm: becalmment
lmn: calmnesses
lmo: ophthalmoblennorrhea
lmp: qualmproof
lms: helmsmanship
lmu: megalophthalmus
lmw: palmwise
lmy: xerophthalmy
lna: methylnaphthalene
lnb: bulnbuln
lnd: gelndesprung
lne: hyperintellectualness
lng: cuailnge
lnh: kilnhole
lni: trinitrophenylmethylnitramine
lnl: lincolnlike
lnm: parhelnm
lno: malnourishment
lnr: kilnrib
lns: kilnstick
lnt: kilntree
lnu: malnutrition
loa: papilloadenocystoma
lob: cyanomethaemoglobin
loc: meningoencephalocele
lod: philodestructiveness
loe: reticuloendothelial
lof: argilloferruginous
log: electroencephalographically
loh: hexahydroxycyclohexane
loi: poluphloisboiotatotic
loj: maxillojugal
lok: megalokaryocyte
lol: crystalloluminescence
lom: polioencephalomyelitis
lon: phenylethylmalonylurea
loo: bloodstainedness
lop: dicyclopentadienyliron
loq: semicolloquially
lor: dichlorodiphenyltrichloroethane
los: philosophicopsychological
lot: cyclotrimethylenetrinitramine
lou: platydolichocephalous
lov: auriculoventricular
low: snailfishessnailflower
lox: antiphylloxeric
loy: unemployableness
loz: maxillozygomatic
lpa: faradopalpation
lpb: pulpboard
lpe: benzylpenicillin
lpf: overhelpfulness
lph: formaldehydesulphoxylate
lpi: oophorosalpingectomy
lpl: helplessness
lpm: helpmates
lpn: stilpnosiderite
lpo: laparocolpohysterotomy
lpr: malpractitioner
lps: pedipalps
lpt: sculpturesqueness
lpu: malpublication
lpw: helpworthy
lpy: polyvinylpyrrolidone
lqg: penetrolqgy
lqn: hlqn
lqu: diphenylquinomethane
lra: gabrielrache
lre: hexylresorcinol
lri: nonchivalric
lro: superchivalrousness
lru: bulrushlike
lry: daredevilry
lsa: acetylsalicylate
lsb: rammelsbergite
lsc: gesellschaften
lsd: culsdesac
lse: falseheartedness
lsf: barrelsful
lsg: palsgravine
lsh: bolshevistically
lsi: electroconvulsive
lsk: aeolsklavier
lsl: toolslide
lsm: spoilsmonger
lsn: weaselsnout
lso: noncompulsoriness
lsp: siliceofelspathic
lss: squirrelsstagnate
lst: diethylstilboestrol
lsu: phenolsulphonephthalein
lsv: dullsville
lsw: bondelswarts
lsy: seneschalsy
lta: unsimultaneousness
ltb: saltbushes
ltc: saltcellars
ltd: meltdowns
lte: helterskelteriness
ltf: unfaultfinding
ltg: saltgrass
lth: phenylthiocarbamide
lti: aquopentamminecobaltic
ltj: dubbeltje
ltl: superdifficultly
ltm: millivoltmeter
ltn: difficultness
lto: subsultorysubsultus
ltp: insultproof
ltr: dichlorodiphenyltrichloroethane
lts: saltsprinkler
ltt: culttelli
ltu: electrohorticulture
ltv: invultvation
ltw: basaltware
lty: counterdifficulty
ltz: eschscholtzia
lua: overvaluableness
lub: nonlubriciousness
luc: benzophloroglucinol
lud: ludicrosplenetic
lue: influenceabilities
luf: outbluffing
lug: nonlugubriousness
luh: gluhwein
lui: magnetofluidmechanics
luj: hallelujatic
luk: lukewarmness
lul: dermatocellulitis
lum: crystalloluminescence
lun: blunderheadedness
luo: chlorotrifluoroethylene
lup: poluphloisboiotatotic
luq: toluquinaldine
lur: phenylethylmalonylurea
lus: overillustratively
lut: counterrevolutionaries
luv: fluvioterrestrial
luw: ahluwalia
lux: superluxuriousness
luy: toluylenediamine
luz: luzula
lva: electrogalvanization
lvd: blvd
lve: coevolvedcoevolves
lvi: pelvioperitonitis
lvo: proctovalvotomy
lvs: solvsbergite
lvu: convolvulaceous
lvv: galvvanoscopy
lvy: shelvy
lwa: antirailwayist
lwe: pickerelweed
lwh: bullwhipping
lwi: cathedralwise
lwl: lwl
lwm: lwm
lwo: stalworthness
lwp: lwp
lwr: wheelwrighting
lwu: mangelwurzel
lxe: calxes
lxx: lxx
lxy: carbolxylol
lya: polyacrylonitrile
lyb: molybdocardialgia
lyc: phosphoglyceraldehyde
lyd: polydenominational
lye: polyesterification
lyf: butterflyfishes
lyg: dioeciopolygamous
lyh: polyhistorian
lyi: substantiallying
lyk: polykaryocyte
lyl: phthalylsulfathiazole
lym: lymphangioendothelioma
lyn: antipolyneuritic
lyo: polyoxymethylene
lyp: phoneticohieroglyphic
lyr: polyribonucleotide
lys: hyperpolysyllabically
lyt: polytetrafluoroethylene
lyu: polyunsaturated
lyv: polyvinylpyrrolidone
lyw: assemblywoman
lyx: cheiropompholyx
lyz: electrolyzability
lza: balzacian
lzb: milzbrand
lze: beelzebubian
lzf: salzfelle
lzh: alzheimer
lzi: capercailzie
lzo: calzoneras
lzy: schmalzy
maa: schoolmaamish
mab: intertransformability
mac: macracanthrorhynchiasis
mad: magnetoplasmadynamics
mae: chamaepericlymenum
maf: enterochromaffin
mag: magnetothermoelectricity
mah: mahayanistic
mai: maintainableness
maj: majoritarianism
mak: hypermakroskelic
mal: formaldehydesulphoxylate
mam: circumambulations
man: mandibulosuspensorial
mao: maorilander
map: pseudohermaphroditism
maq: passamaquoddy
mar: demarcatordemarcators
mas: sternocleidomastoideus
mat: hematospectrophotometer
mau: hemautographic
mav: circumaviation
maw: balmawhapple
max: maxillopremaxillary
may: dismayingness
maz: chlorpromazine
mba: lautenclavicymbal
mbb: dumbbeller
mbc: crumbcloth
mbd: paralambdacismus
mbe: overembellishment
mbf: dumbfounderment
mbh: sambhogakaya
mbi: pseudoambidextrously
mbk: lambkills
mbl: emblematicalness
mbm: disentombment
mbn: dumbnesses
mbo: pylethrombophlebitis
mbp: thumbpiece
mbr: membranocartilaginous
mbs: dumbstricken
mbt: thumbtacking
mbu: semisomnambulistic
mbw: dumbwaiters
mby: bombycillidae
mca: circumcallosal
mcc: mccarthyism
mcd: mcdonald
mce: circumcellion
mcf: mcf
mcg: mcg
mch: bottomchrome
mci: uncircumcisedness
mck: mckay
mcl: circumclusion
mcn: imcnt
mco: circumcolumnar
mcp: mcphail
mcr: circumcrescence
mcu: cirmcumferential
mcy: seldomcy
mda: circumdate
mde: circumdenudation
mdg: comdg
mdi: chromdiagnosis
mdl: fremdly
mdm: hamdmaid
mdn: fremdness
mdo: knockemdown
mdr: humdrummishness
mds: mdse
mdt: imdtly
mdu: deorusumduction
mea: impermeabilization
meb: pseudoameboid
mec: magnetofluidmechanics
med: pericardiomediastinitis
mee: meekheartedness
mef: unshamefacedness
meg: megachiropterous
meh: tameheartedness
mei: sialosemeiology
mej: jeremejevite
mek: undergamekeeper
mel: pseudolamellibranchiata
mem: membranocartilaginous
men: antidisestablishmentarianism
meo: homeotransplantation
mep: mephistopheleanly
meq: ramequins
mer: overcommercialization
mes: archaeopterygiformes
met: cyclotrimethylenetrinitramine
meu: yponomeutidae
mev: wheresomever
mew: unblameworthiness
mex: iridomyrmex
mey: meyerhofferite
mez: photomezzotype
mfa: idemfactor
mfd: mmfd
mfe: semicircumferentor
mfg: mfg
mfi: sargassumfishes
mfl: circumflexion
mfo: discomfortableness
mfr: demichamfron
mfs: bumfs
mfu: circumfulgent
mfy: uncomfy
mga: damgalnunna
mgd: mgd
mge: circumgestation
mgh: samgha
mgi: nakomgilisala
mgo: filmgoers
mgr: grimgribber
mgt: mgt
mgu: rumgumptious
mgy: circumgyration
mha: baumhauerite
mhe: warmheartedness
mhg: mhg
mhi: chromhidrosis
mho: circumhorizontal
mhp: lymhpangiophlebitis
mhr: amhran
mhu: hamhung
mhy: bromhydrate
mhz: mhz
mia: semianthropologically
mib: semibureaucratically
mic: microspectrophotometrically
mid: blepharochromidrosis
mie: hepaticoenterostomies
mif: semifigurativeness
mig: semigovernmentally
mih: semihydrobenzoinic
mii: semiintoxicated
mij: semijuridically
mik: akiskemikinik
mil: antimilitaristically
mim: parasympathomimetic
min: cyclotrimethylenetrinitramine
mio: overabstemiousness
mip: semiprofessionalized
miq: hemidemisemiquaver
mir: hypermiraculousness
mis: premisrepresentation
mit: trihemitetartemorion
miu: semiuniversalist
miv: semivitrification
miw: semiweeklies
mix: hypermixolydian
miy: semiyearlies
miz: thyroparathyroidectomize
mja: circumjacencies
mje: ramjets
mjl: getmjlkost
mjo: circumjovial
mju: decemjugate
mka: chamkanni
mke: naumkeager
mkh: gymkhanas
mki: bloomkin
mkj: damkjernite
mko: dummkopfs
mks: mks
mkt: mktg
mku: kumkum
mky: dumky
mla: phantomland
mle: bottomlessness
mli: unbridegroomlike
mlo: circumlocutionary
mlu: ferthumlungur
mlx: mlx
mly: noncruciformly
mma: hypergrammaticalness
mmb: aummbulatory
mmd: melammdim
mme: overcommercialization
mmf: mmfd
mmh: krummholz
mmi: aquopentamminecobaltic
mmk: dummkopfs
mml: nachtmml
mmm: mmmm
mmn: programmng
mmo: nonaccommodatingness
mmp: ummps
mmr: stammrel
mms: mumms
mmu: immunoelectrophoretically
mmy: flummydiddle
mna: countercondemnation
mnb: hymnbooks
mnc: solemncholy
mnd: goddamndest
mne: anamnestically
mng: programmng
mni: omnirepresentativeness
mnl: supersolemnly
mnn: supersolemnness
mno: hypsiprymnodontinae
mns: precondemns
mnt: preconfinemnt
mnu: circumnutating
mnw: columnwise
mny: damnyankee
moa: chemoautotrophically
mob: ophthalmoblennorrhea
moc: pyopneumocholecystitis
mod: epididymodeferentectomy
moe: magnetothermoelectricity
mof: tetrabromofluorescein
mog: plethysmographically
moh: pneumohydropericardium
moi: ureterosigmoidostomy
moj: thermojunction
mok: thermokinematics
mol: thymolsulphonephthalein
mom: electrotelethermometer
mon: pseudomonocotyledonous
moo: dermoossification
mop: hydropneumopericardium
moq: vigesimoquarto
mor: anthropomorphologically
mos: gastroenteroanastomosis
mot: chemotherapeutically
mou: semiblasphemousness
mov: pneumoventriculography
mow: automower
mox: chromoxylography
moy: hydrocinnamoyl
moz: squamozygomatic
mpa: arteriosympathectomy
mpb: campbellisms
mpc: dampcourse
mpd: clampdown
mpe: nonimperialistically
mpf: crampfishes
mpg: campgrounds
mph: lymphangioendothelioma
mpi: stereocampimeter
mpk: pumpkinification
mpl: noncontemplativeness
mpm: encampments
mpn: overplumpness
mpo: noncontemporaneousness
mpp: dampproofing
mpq: umpqua
mpr: superincomprehensibleness
mps: metempsychosical
mpt: overpresumptuousness
mpu: multimicrocomputer
mpv: impv
mpw: lampworking
mpy: campylospermous
mqu: circumquaque
mra: circumradiuses
mre: circumrenal
mrg: smrgs
mri: dharmasmriti
mro: circumrotating
mrp: lagomrph
mrr: smrrebrd
mrs: mrs
mru: rumrunners
mrx: admrx
mry: bottomrying
msa: circumsaturnian
msb: bloomsburian
msc: uncircumscribedness
msd: doomsdays
mse: antiserumsera
msf: almsfolk
msg: almsgiving
msh: bridegroomship
msi: unwhimsicalness
msk: numskulledness
msl: boomslange
msm: platinumsmith
mso: williamsoniaceae
msp: noncircumspectness
msq: broomsquire
mss: bremsstrahlung
mst: circumstantiability
msu: bumsucking
msw: rumswizzle
msy: dreamsy
mta: circumtabular
mtd: mtd
mte: circumterrestrial
mtg: mtge
mth: warmthlessness
mti: steamtightness
mtl: jamtland
mtm: amtman
mtn: mtn
mto: circumtonsillar
mtr: circumtropical
mts: mtscmd
mtu: tumtum
mtx: mtx
mty: leimtype
mua: remuable
mub: mubarat
muc: saccharomucilaginous
mud: muddleheadedness
mue: muehlenbeckia
muf: ragamuffinism
mug: muggletonianism
muh: humuhumunukunukuapuaa
mui: decemuiri
muj: mujtahid
muk: gitanemuk
mul: multidimensionality
mum: hamamelidanthemum
mun: immunoelectrophoretically
muo: muonium
mup: tumupasa
muq: timuquanan
mur: hyperoxymuriatic
mus: ethnomusicologically
mut: phosphoglucomutase
muu: muumuus
muv: muvule
mux: mux
muy: amuyong
muz: muzzleloading
mva: noncircumvallated
mve: deorsumvergence
mvi: quindecemvirate
mvo: semicircumvolution
mwa: upstreamward
mwe: bantamweights
mwh: dreamwhile
mwi: dimwittedness
mwo: aimworthiness
mxd: mxd
mya: coeliomyalgia
myb: barmybrained
myc: triacetyloleandomycin
myd: chlamydobacteriaceous
mye: polioencephalomyelitis
myg: pharyngoamygdalitis
myh: mummyhood
myi: cecidomyiidous
myk: mykiss
myl: hydroformylation
mym: mymaridae
myn: mynpachtbrief
myo: electromyographically
myp: chlamyphorus
myr: myringodermatitis
mys: hypermysticalness
myt: demythologizations
myw: clammyweed
myx: chondromyxosarcoma
myz: myzodendraceous
mza: hamzahs
mze: circumzenithal
mzi: lamziekte
mzl: chremzlach
mzu: mzungu
mzy: mimzy
naa: canaanitess
nab: overimpressionableness
nac: pseudoanachronistical
nad: nonadministratively
nae: hypsiprymnodontinae
naf: unaffectionateness
nag: anagrammatization
nah: madonnahood
nai: snailfishessnailflower
naj: guanajuatite
nak: hyperanakinesia
nal: pseudointernationalistic
nam: magnetohydrodynamically
nan: nonanachronistically
nao: magindanao
nap: naphthylaminesulphonic
naq: menaquinone
nar: counterrevolutionaries
nas: gastroenteroanastomosis
nat: pseudointernationalistic
nau: nonautobiographically
nav: astragalonavicular
naw: unawardableness
nax: nonaxiomatically
nay: hannayite
naz: dibenzophenazine
nba: nonbarbarousness
nbb: inbbred
nbd: inbd
nbe: manganhedenbergite
nbg: nbg
nbi: nonbiographically
nbl: nonblasphemousness
nbo: swedenborgianism
nbr: unbreachableness
nbu: nonbureaucratically
nby: downbye
nca: noncannibalistically
ncc: canccelli
nce: electroencephalographically
ncg: incgrporate
nch: macracanthrorhynchiasis
nci: counterpronunciamento
nck: dezincking
ncl: superinclusiveness
ncm: blancmanger
ncn: disfrancnise
nco: superincomprehensibleness
ncp: pincpinc
ncr: pancreaticoduodenostomy
ncs: archebancs
nct: blepharosphincterectomy
ncu: concupiscibleness
ncy: noninterdependency
nda: supersuperabundantly
ndb: diamondbacked
ndc: stepgrandchild
ndd: granddaughterly
nde: supertranscendentness
ndf: blindfoldedness
ndg: landgraveship
ndh: secondhandedness
ndi: overindividualistically
ndj: windjammers
ndk: handkerchiefful
ndl: candlestickward
ndm: grandmotherliness
ndn: undergroundness
ndo: lymphangioendothelioma
ndp: grandparenthood
ndq: hindquarters
ndr: dendrochronologically
nds: secondsightedness
ndt: spendthriftiness
ndu: overindustrialization
ndv: andvari
ndw: shorthandwriter
ndy: spondylotherapeutics
ndz: akhundzada
nea: cineangiocardiographic
neb: brigantinebrigantines
nec: diphenylaminechlorarsine
ned: pentamethylenediamine
nee: chemicoengineering
nef: ineffervescibility
neg: overneglectfulness
neh: boneheadedness
nei: bretschneideraceae
nej: nonejaculatory
nek: akanekunik
nel: nonelectrification
nem: anemometrographically
nen: nonenthusiastically
neo: noncontemporaneousness
nep: phenolsulphonephthalein
neq: phenanthrenequinone
ner: regeneratoryregeneratress
nes: superincomprehensibleness
net: cyclotrimethylenetrinitramine
neu: hydropneumopericardium
nev: pseudobenevolently
new: newfangledness
nex: unextinguishableness
ney: cockneyfication
nez: nebuchadnezzar
nfa: nonfashionableness
nfd: tranfd
nfe: preinferredpreinferring
nff: unffroze
nfi: nonconfidentialness
nfl: antiinflammatories
nfo: superconformableness
nfr: archconfraternities
nfu: nonfundamentalist
nfy: hunfysh
nga: counterdisengagement
ngb: strongbrained
ngc: thlingchadinne
ngd: farthingdeal
nge: noninterchangeableness
ngf: unmeaningfulness
ngg: microsporanggia
ngh: stringhaltedness
ngi: cineangiocardiographic
ngj: engjateigur
ngk: lovingkindness
ngl: overdiscriminatingly
ngm: restoringmoment
ngn: nonaccommodatingness
ngo: dacryocystosyringotomy
ngp: preobtrudingpreobtrusion
ngr: congregationalists
ngs: misunderstandings
ngt: diminishingturns
ngu: nondistinguishableness
ngw: measuringworm
ngy: strongyloplasmata
nha: schopenhauereanism
nhe: chickenheartedness
nhi: nonhistrionicalness
nhn: houyhnhnm
nho: nonhomogeneousness
nhs: sinhs
nhu: nonhumorousness
nhw: chinhwan
nhy: nonhygroscopically
nia: microminiaturizations
nib: noncannibalistically
nic: counterexcommunication
nid: sulfanilylguanidine
nie: inconvenientness
nif: cartilaginification
nig: nonignominiousness
nih: annihilationistical
nii: macraucheniiform
nij: senijextee
nik: akiskemikinik
nil: dimethylanthranilate
nim: nonimpressionableness
nin: noninterchangeableness
nio: nonsanctimoniousness
nip: plenipotentiaryship
niq: machinotechnique
nir: omnirepresentativeness
nis: antidisestablishmentarianism
nit: cyclotrimethylenetrinitramine
niu: tetramethylammonium
niv: noncarnivorousness
niw: pinniwinkis
nix: uniprocessorunix
niy: guberniya
niz: counterrevolutionize
nja: zinjanthropus
nje: conjecturableness
nji: munjistin
njo: nonjournalistically
njr: pinjra
nju: blepharoconjunctivitis
njy: benjy
nka: undrinkableness
nkb: stinkberries
nkc: crankcases
nkd: junkdealer
nke: cantankerousness
nkf: superthankfulness
nkg: ginkgoaceous
nkh: frankheartedness
nki: unshrinkingness
nkk: tankka
nkl: hydrofranklinite
nkm: blankmindedness
nkn: nonknowledgeable
nko: drunkometer
nkp: frankpledge
nkr: pseudobankrupt
nks: brinksmanship
nkt: nannoplanktonic
nku: brankursine
nkw: thankworthiness
nky: ankyloblepharon
nla: schlauraffenland
nle: unlexicographically
nli: ungentlemanlikeness
nlo: unloquaciousness
nlt: unltraconservative
nlu: nonlubriciousness
nly: mephistopheleanly
nma: nonmaterialistically
nme: antienvironmentalists
nmi: unmisunderstandable
nmn: panmnesia
nmo: unmorphologically
nmp: inmprovidence
nmu: nonmultiplicational
nmy: nonmythologically
nna: counterreconnaissance
nnc: rinncefada
nne: interconnectedness
nng: foenngreek
nnh: jotunnheim
nni: noncannibalistically
nnk: innkeepers
nnl: tonnland
nnm: finnmarks
nnn: bonnnes
nno: dacryocystoblennorrhea
nns: assmannshauser
nnu: nonnutritiousness
nnw: zinnwaldite
nny: psychopannychistic
noa: aminoacetophenetidine
nob: monobromoacetanilide
noc: duodenocholecystostomy
nod: hypsiprymnodontinae
noe: immunoelectrophoretically
nof: galvanofaradization
nog: photochronographically
noh: abdominohysterectomy
noi: ethmopresphenoidal
noj: duodenojejunostomies
nok: mannoketoheptose
nol: tetraiodophenolphthalein
nom: interdenominationalism
non: noncontemporaneousness
noo: planoorbicular
nop: duodenopancreatectomy
noq: aminoquinoline
nor: dacryocystoblennorrhea
nos: pancreaticoduodenostomy
not: mechanotheraputically
nou: pseudomonocotyledonous
nov: intestinovesical
now: disacknowledgements
nox: benzofuroquinoxaline
noy: annoyingness
noz: ethnozoological
npa: nonpantheistically
npe: nonperpendicularity
npf: hassenpfeffer
nph: nonpharmaceutically
npi: unpicturesqueness
npk: tnpk
npl: unplatitudinousness
npn: nonpneumatically
npo: nonportentousness
npr: nonproportionateness
nps: nonpsychoanalytically
npt: apopenptic
npu: nonpurchasability
npy: chlorprophenpyridamine
nqi: inqilab
nqu: superinquisitiveness
nra: nonrationalistically
nre: nonrepresentationalism
nrg: paaneleinrg
nrh: unrhetoricalness
nri: nonritualistically
nrl: evanescenrly
nro: unromanticalness
nrr: unrrove
nru: nonrudimentariness
nry: tatterdemalionry
nsa: nonsanctimoniousness
nsb: transbaikalian
nsc: hyperconscientiousness
nsd: transdiaphragmatic
nse: hyperconservativeness
nsf: intertransformability
nsg: nontransgressively
nsh: handicraftsmanship
nsi: superincomprehensibleness
nsj: transjordanian
nsk: nordenskioldine
nsl: countertranslation
nsm: transmogrifications
nsn: transnationally
nso: mandibulosuspensorial
nsp: heterotransplantation
nsq: unsqueamishness
nsr: transrectification
nss: superinsscribing
nst: deinstitutionalization
nsu: transubstantiationalist
nsv: intertransversalis
nsw: unanswerableness
nsy: nonsyllogistically
nta: antidisestablishmentarianism
ntb: frontbencher
ntc: serpentcleide
ntd: countdowns
nte: pseudointernationalistic
ntf: unresentfulness
ntg: appendorontgenography
nth: anthropomorphologically
nti: antidisestablishmentarianism
ntj: baviaantje
ntk: giantkind
ntl: supersuperabundantly
ntm: unabsentmindedness
ntn: supertranscendentness
nto: counterpronunciamento
ntp: punishmentproof
ntr: astrospherecentrosomic
nts: disacknowledgements
ntt: preventtoria
ntu: noncontumaciousness
ntv: pontvolant
ntw: countercurrentwise
nty: nontypographically
ntz: chintziness
nua: prediscontinuation
nub: nonubiquitousness
nuc: desoxyribonucleoprotein
nud: circumdenudation
nue: prediscontinue
nuf: nonmanufacturing
nug: lanuginousness
nui: superingenuities
nuk: humuhumunukunukuapuaa
nul: lymphogranulomatosis
num: americanumancestors
nun: counterpronunciamento
nuo: nondisingenuousness
nup: nonupholstered
nuq: nuque
nur: hematoporphyrinuria
nus: pharyngopalatinus
nut: nonnutritiousness
nuu: semicontinuum
nuv: sinuventricular
nux: unuxoriousness
nuy: ennuyante
nuz: nuzzerana
nva: postconvalescents
nve: anticonventionalism
nvi: antienvironmentalists
nvo: nonvolatilizable
nvt: invt
nvu: electroconvulsive
nvv: nonvvacua
nvy: unenvyingly
nwa: unwarrantableness
nwe: commonwealthism
nwh: unwhimsicalness
nwi: processionwise
nwo: unwoundableness
nwr: nonwrinkleable
nww: enwwoven
nwy: vyrnwy
nxe: laryngopharynxes
nxi: overanxiousness
nxl: sphinxlike
nxm: manxman
nxr: banxring
nxs: minxship
nxt: pinxter
nxw: manxwoman
nya: unyachtsmanlike
nyb: nannyberries
nyc: psychopannychistic
nyd: johnnydom
nye: intensivenyess
nyf: pennyflower
nyg: conyger
nyh: stonyheartedness
nyi: nonaccompanying
nyk: grannyknot
nyl: dichlorodiphenyltrichloroethane
nym: desynonymization
nyn: epionynychia
nyo: genyophrynidae
nyp: miminypiminy
nyr: scammonyroot
nys: gonystylaceous
nyt: anythingarianism
nyu: banyuls
nyv: bonnyvis
nyw: threepennyworth
nyx: scleroticonyxis
nyz: conyza
nza: benzalphenylhydrazone
nzb: benzbitriazole
nzd: benzdioxtriazine
nze: alkylbenzenesulfonates
nzh: benzhydroxamic
nzi: zinziberaceous
nzk: lanzknecht
nzo: benzofuroquinoxaline
nzp: benzpinacone
nzs: tranzschelia
nzt: benztrioxazine
nzu: binzuru
nzy: benzylpenicillin
oab: thoracicoabdominal
oac: aminoacetophenetidine
oad: papilloadenocystoma
oae: pseudoaesthetically
oaf: pseudoaffectionately
oag: bacterioagglutinin
oah: coahuiltecan
oai: hydroairplane
oaj: goajiro
oak: cloakmaking
oal: reticulatocoalescent
oam: pseudoambidextrously
oan: gastroenteroanastomosis
oao: endoaortitis
oap: pseudoapologetically
oaq: glacioaqueous
oar: pseudoaristocratically
oas: theologicoastronomical
oat: pyramidoattenuate
oau: zygomaticoauricularis
oav: bioavailability
oaw: coawareness
oax: subclavioaxillary
oaz: amidoazobenzene
oba: aquopentamminecobaltic
obb: hobbledehoyishness
obc: obcompressed
obd: obdiplostemonous
obe: methyltrinitrobenzene
obf: unobfuscated
obg: hobgoblins
obh: hobhouchin
obi: nonautobiographically
obj: overobjectification
obk: knobkerrie
obl: dacryocystoblennorrhea
obm: obmutescence
obn: unobnoxiousness
obo: laryngostroboscope
obp: obpyramidal
obr: monobromoacetanilide
obs: nonobstructiveness
obt: preobtrudingpreobtrusion
obu: azoisobutyronitrile
obv: nonobviousness
obw: cobwebbiest
oby: acrobystitis
obz: dobzhansky
oca: electrocardiographically
ocb: procbal
occ: antistaphylococcic
ocd: myocdia
oce: hypsidolichocephalism
och: choledochoduodenostomy
oci: chronocinematography
ock: unbluestockingish
ocl: sternocleidomastoideus
ocm: socmanry
ocn: dolichocnemic
oco: hydroxydehydrocorticosterone
ocq: docquet
ocr: microcryptocrystalline
ocs: betocsin
oct: counterindoctrination
ocu: ethylhydrocupreine
ocy: dacryocystoblennorrhea
ocz: proczarist
oda: nonaccommodatingness
odb: woodburytype
odc: bloodcurdlingly
odd: demigoddessship
ode: epididymodeferentectomy
odf: godfatherhood
odg: bloodguiltiness
odh: goodheartedness
odi: dichlorodiphenyltrichloroethane
odj: woodjobber
odk: clodknocker
odl: quodlibetically
odm: godmotherhood
odn: misunderstoodness
odo: tetraiodophenolphthalein
odp: codpitchings
odr: nonmelodramatically
ods: bloodstainedness
odt: bloodthirstiness
odu: pancreaticoduodenostomy
odw: hoodwinkable
ody: magnetohydrodynamically
odz: podzolization
oea: polyphloesboean
oeb: amoebobacterieae
oec: pseudoeconomically
oed: pseudoeducationally
oee: whencesoeer
oef: corticoefferent
oeg: bronchoegophony
oeh: shoehorning
oei: onomatopoeically
oek: koeksotenok
oel: immunoelectrophoretically
oem: neuroembryological
oen: electroencephalographically
oeo: homoeocrystalline
oep: pharyngoepiglottidean
oeq: pseudoequalitarian
oer: pseudoerysipelatous
oes: bronchoesophagoscopy
oet: dichlorodiphenyltrichloroethane
oeu: outmanoeuvering
oev: pseudoevangelically
oew: canoewood
oex: pseudoexperimentally
oey: mosquittoey
oez: troezenian
ofa: brachiofaciolingual
ofb: goofballs
ofd: okshoofd
ofe: semiprofessionalized
off: superoffensiveness
ofi: osteochondrofibroma
ofk: sofkee
ofl: magnetofluidmechanics
ofm: hoofmarks
ofn: weatherproofness
ofo: chloroformization
ofp: hoofprint
ofr: phosphofructokinase
ofs: burglarproofs
oft: softheartedness
ofu: benzofuroquinoxaline
ofw: hoofworm
ofy: introfying
oga: pancreaticogastrostomy
ogb: dogberrydom
ogc: ogcocephalidae
ogd: sogdianese
oge: scientificogeographical
ogf: dogfighting
ogg: bulldoggishness
ogh: cooghneiorvlt
ogi: philosophicopsychological
ogj: jogjakarta
ogl: prorhipidoglossomorpha
ogm: overdogmaticalness
ogn: pharmacognostically
ogo: logogrammatically
ogp: logperches
ogr: electroencephalographically
ogs: demihogshead
ogt: bogtrotting
ogu: antigalactagogue
ogv: dogvanes
ogw: dogwatches
ogy: pharmacoendocrinology
oha: phytohaemagglutinin
ohe: hexahydroxycyclohexane
ohi: pathologicohistological
ohj: shohjis
ohl: trentepohliaceous
ohm: toernebohmite
ohn: mendelssohnian
oho: anthrohopobiological
ohp: poohpoohist
ohr: mohrodendron
ohs: pharaohs
oht: dohter
ohu: biologicohumanistic
ohv: ohv
ohw: mohwa
ohy: magnetohydrodynamically
oia: blepharodyschroia
oib: foiblesse
oic: stoicheiometrically
oid: thyroparathyroidectomize
oie: granulocytopoiesis
oif: coiffeuses
oig: frankalmoigne
oih: hoihere
oii: croiik
oik: micropoikilitic
oil: cholecystoileostomy
oim: squamosoimbricated
oin: pseudointernationalistic
oio: poluphloisboiotatotic
oip: cincholoiponic
oir: sclerokeratoiritis
ois: poluphloisboiotatotic
oit: reconnoiteringly
oiv: voivodeship
oix: lacroixite
oiy: taoiya
oiz: cuprodescloizite
oja: ammoniojarosite
ojd: slojds
oje: cholecystojejunostomy
oji: projiciently
ojk: pirojki
ojo: photojournalistic
ojp: bhojpuri
oju: philosophicojuristic
oka: agathokakological
okb: bookbinderies
okc: bookcases
okd: bookdealer
oke: sclerokeratoiritis
okf: crookfingered
okh: crookheaded
oki: phosphofructokinase
okj: toktokje
okk: subbookkeeper
okl: bibliokleptomaniac
okm: bokmakierie
okn: crooknecked
oko: pneumonokoniosis
okp: bookplates
okr: kosmokrator
oks: crookshouldered
okt: crooktoothed
oku: leptokurtosis
okv: stokvis
okw: bookwright
oky: stethokyrtograph
ola: pseudolamellibranchiata
olb: calciovolborthite
olc: semivolcanically
old: antistadholderian
ole: dihdroxycholecalciferol
olf: phosphowolframic
olg: schoolgirlishness
olh: coolheadedness
oli: polioencephalomyelitis
olj: polje
olk: volkerwanderung
oll: chromocollographic
olm: schoolmasterishness
oln: lincolnesque
olo: philosophicopsychological
olp: tetraiodophenolphthalein
olq: penetrolqgy
olr: cholralosed
ols: phenolsulphonephthalein
olt: voltaelectrometric
olu: counterrevolutionaries
olv: coevolvedcoevolves
olw: patrolwoman
olx: carbolxylol
oly: polytetrafluoroethylene
olz: krummholz
oma: lymphangioendothelioma
omb: pylethrombophlebitis
omc: bottomchrome
omd: chromdiagnosis
ome: microspectrophotometrically
omf: discomfortableness
omg: nakomgilisala
omh: chromhidrosis
omi: thyroparathyroidectomize
omj: tomjohn
omk: roomkeeper
oml: unbridegroomlike
omm: counterexcommunication
omn: omnirepresentativeness
omo: anthropomorphologically
omp: superincomprehensibleness
omr: precomradeship
oms: bridegroomship
omt: blossomtime
omu: ethnomusicologically
omv: bromvogel
omw: cromwellian
omy: blepharosphincterectomy
omz: momzer
ona: pseudointernationalistic
onb: nonbureaucratically
onc: noncontemporaneousness
ond: nondistinguishableness
one: hydroxydehydrocorticosterone
onf: anticonfederationism
ong: pseudoconglomeration
onh: nonhistrionicalness
oni: naphthylaminesulphonic
onj: blepharoconjunctivitis
onk: nonknowledgeable
onl: expressionlessness
onm: antienvironmentalists
onn: counterreconnaissance
ono: photochronographically
onp: nonpsychoanalytically
onq: nonquantitativeness
onr: nonrepresentationalism
ons: counterclassifications
ont: noncontemporaneousness
onu: desoxyribonucleoprotein
onv: anticonventionalism
onw: commonwealthism
onx: bonxie
ony: phenylethylmalonylurea
onz: nonzoologically
ooa: mooachaht
oob: staroobriadtsi
ooc: electrooculogram
ood: misunderstoodness
ooe: interzooecial
oof: perforationproof
oog: zoogeographically
ooh: poohpoohist
ooi: antherozooidal
ooj: boojum
ook: crookshouldered
ool: zoologicoarchaeologist
oom: unbridegroomlike
oon: contrabassoonist
ooo: oooo
oop: oophorosalpingectomy
oor: pseudoorthorhombic
oos: electroosmotically
oot: epizootiologically
oou: heteroousiast
oov: behoovefulness
oow: warkamoowee
oox: photooxidation
ooy: fooyoung
ooz: bamboozlement
opa: thyroparathyroidectomize
opb: shopbreaking
opc: topcoating
opd: turveydropdom
ope: aquopentamminecobaltic
opf: scoopfulfuls
opg: stoopgallant
oph: trinitrophenylmethylnitramine
opi: pseudophilanthropically
opj: propjets
opk: hopkinsianism
opl: magnetoplasmadynamics
opm: counterdevelopment
opn: hydropneumopericardium
opo: anthropomorphologically
opp: nonopprobriousness
opr: desoxyribonucleoprotein
ops: philosophicopsychological
opt: archaeopterygiformes
opu: electropuncturation
opv: chronoscopv
opw: scallopwise
opy: isopropylideneacetone
oqu: benzofuroquinoxaline
ora: diphenylaminechlorarsine
orb: orbiculatoelliptical
orc: resorcinolphthalein
ord: demarcatordemarcators
ore: immunoelectrophoretically
orf: alligatorfishes
org: counterorganization
orh: macracanthrorhynchiasis
ori: historicocabbalistical
orj: forjudgment
ork: counterbreastwork
orl: anteroposteriorly
orm: formaldehydesulphoxylate
orn: hesperornithiformes
oro: dichlorodiphenyltrichloroethane
orp: anthropomorphologically
orq: torquated
orr: cholecystenterorrhaphy
ors: demarcatordemarcators
ort: hydroxydehydrocorticosterone
oru: heautontimorumenos
orv: cooghneiorvlt
orw: unstraightforwardness
ory: regeneratoryregeneratress
orz: borzicactus
osa: oophorosalpingectomy
osb: grosbeaks
osc: stereomicroscopically
ose: microseismometrograph
osg: thiophosgene
osh: electrosherardizing
osi: gastroenteroanastomosis
osj: bosjesman
osk: splanchnoskeletal
osl: czechoslovakians
osm: cosmopolitanisation
osn: prosneusis
oso: philosophicopsychological
osp: microspectrophotometrically
osq: mastoideosquamous
osr: keratosropy
oss: prorhipidoglossomorpha
ost: hydroxydehydrocorticosterone
osu: mandibulosuspensorial
osw: pseudosweating
osy: dacryocystosyringotomy
osz: groszy
ota: poluphloisboiotatotic
otb: footballist
otc: scotchification
otd: hotdogging
ote: desoxyribonucleoprotein
otf: parrotfishes
otg: shotgunning
oth: magnetothermoelectricity
oti: scleroticochorioiditis
otj: bootjacks
otk: notkerian
otl: scotlandwards
otm: footmenfootpad
otn: abbotnullius
oto: microspectrophotometrically
otp: photphotonegative
otq: cotqueans
otr: cyclotrimethylenetrinitramine
ots: bootstrapping
ott: pharyngoepiglottidean
otu: scrofulotuberculous
otw: notwithstanding
otx: plotx
oty: pseudomonocotyledonous
otz: shkotzim
oua: bivouacking
oub: doubleheartedness
ouc: counteravouchment
oud: cloudlessness
oue: silhouettograph
ouf: camouflageable
oug: forethoughtfulness
ouh: brouhahas
oui: bouillabaisse
ouj: foujdarry
ouk: joukerypawkery
oul: laboulbeniaceous
oum: bishydroxycoumarin
oun: counterclassifications
ouo: acouophonia
oup: intercoupling
ouq: fouquieriaceous
our: nonjournalistically
ous: hyperconscientiousness
out: outsophisticating
ouu: souushy
ouv: gouvernantes
ouw: souwester
oux: arquifoux
ouy: rocouyenne
ouz: douzainier
ova: ovariosalpingectomy
ovc: novcic
ove: overindividualistically
ovi: sulphureovirescent
ovk: sovkhozes
ovl: bovld
ovn: chinovnik
ovo: nonprovocativeness
ovp: sovprene
ovr: sovranties
ovs: tchaikovsky
ovt: berkovtsi
ovu: superovulation
ovv: improvvisatore
ovy: dovyalis
owa: disallowableness
owb: shallowbrained
owc: flowcharting
owd: chowderheadedness
owe: snailfishessnailflower
owf: oversorrowfulness
owg: shadowgraphist
owh: hollowheartedness
owi: overflowingness
owj: showjumping
owk: yellowknife
owl: disacknowledgements
owm: overshadowment
own: daffadowndillies
owo: phosphowolframic
owp: pericowperitis
owq: cowquake
owr: plowrightia
ows: schoolfellowship
owt: thoroughgrowth
owu: tamanowus
owv: lowville
oww: slowwittedly
owy: marshmallowy
owz: blowziness
oxa: benzofuroquinoxaline
oxb: roxburghiaceae
oxc: coxcombicality
oxd: benzdioxdiazine
oxe: antiphylloxeric
oxf: boxfishes
oxg: foxgloves
oxh: boxhauling
oxi: peroxidicperoxiding
oxk: boxkeeper
oxl: antiorthodoxly
oxm: pyroxmangite
oxn: unorthodoxness
oxo: paradoxographical
oxp: oxpeckers
oxr: boxroom
oxs: coxswaining
oxt: benzdioxtriazine
oxu: paradoxurinae
oxv: knoxvillite
oxw: coxwaining
oxy: hydroxydehydrocorticosterone
oya: unemployableness
oyb: soybeans
oyc: counterboycott
oyd: hobbledehoydom
oye: voyeuristically
oyf: overjoyfulness
oyg: stroygood
oyh: hobbledehoyhood
oyi: hobbledehoyishness
oyl: pteroylglutamic
oym: underemployment
oyn: overcoyness
oyo: pseudoyohimbine
oyp: joypopping
oyr: joyridden
oys: boysenberries
oyt: paleoytterbium
oyu: centrosoyus
oyw: toywoman
oza: lallapalooza
ozc: izvozchik
oze: pseudozealously
ozh: manabozho
ozi: hydrofluozirconic
ozl: bamboozlement
ozn: kolkhoznik
ozo: trapezophozophora
ozs: ozs
ozu: aburabozu
ozy: squamosozygomatic
ozz: pestalozzianism
paa: paaraphimosis
pab: supercapabilities
pac: peripachymeningitis
pad: pratiyasamutpada
pae: encyclopaedically
paf: trypaflavine
pag: cephalothoracopagus
pah: uncompahgrite
pai: countercampaign
paj: pajahuello
pak: zaklohpakap
pal: palaeodendrologically
pam: pamprodactylism
pan: pancreaticoduodenostomy
pao: dopaoxidase
pap: papilloadenocystoma
paq: roentgenopaque
par: thyroparathyroidectomize
pas: incompassionateness
pat: pathologicopsychological
pau: pauciarticulated
pav: pseudopapaverine
paw: joukerypawkery
pax: harpaxophobia
pay: nonprepayment
paz: topazolite
pba: schapbachite
pbb: upbborne
pbe: archcupbearer
pbi: sheepbiting
pbl: lampblacking
pbo: clapboarding
pbr: stepbrotherhood
pbs: mpbs
pbu: shipbuilders
pbx: pbxes
pby: upbye
pca: dumpcarts
pcd: gpcd
pce: loupcerviers
pcf: pcf
pch: stepchildren
pci: upcity
pcl: upclimbing
pcm: pcm
pco: dampcourse
pcr: whipcracker
pct: pct
pcu: upcurling
pcy: bankrupcy
pda: slapdasheries
pde: skipdent
pdi: hyphopdia
pdl: pdl
pdn: pdn
pdo: turveydropdom
pdq: pdq
pdr: snapdragons
pdt: expdt
pea: nonimpeachability
peb: orbitopalpebral
pec: microspectrophotometrically
ped: nonexpeditiousness
pee: speechification
pef: stupefactiveness
peg: bibliopegistical
peh: crapehanger
pei: tapeinocephalism
pej: nonpejoratively
pek: weitspekan
pel: pseudoerysipelatous
pem: underdevelopement
pen: aquopentamminecobaltic
peo: countrypeople
pep: aminopolypeptidase
peq: pequot
per: superincomprehensibleness
pes: overpessimistically
pet: overcompetitiveness
peu: psychotherapeutically
pev: grapevines
pew: teletypewriters
pex: trachelectomopexia
pey: laspeyresia
pez: trapeziometacarpal
pfa: sheepfacedness
pfc: pfc
pfd: pfd
pfe: hassenpfeffer
pff: kupfferite
pfg: pfg
pfi: crampfishes
pfl: topflighter
pfo: sweepforward
pfr: deepfreezing
pfs: dummkopfs
pfu: overhelpfulness
pfx: setpfx
pga: stoopgallant
pge: upget
pgi: shopgirlish
pgl: popglove
pgn: pgnttrp
pgo: deepgoing
pgr: stepgrandfather
pgu: popgunnery
pha: electroencephalographically
phb: sulphbismuthite
phe: dichlorodiphenyltrichloroethane
phg: morphgan
phh: sulphhemoglobin
phi: electroencephalographically
phl: poluphloisboiotatotic
phm: sulphmethemoglobin
phn: chamaedaphne
pho: microspectrophotometrically
php: nephphridia
phr: cholecystonephrostomy
phs: electroencephalographs
pht: tetraiodophenolphthalein
phu: hydrodesulphurization
phw: triumphwise
phy: electrophotomicrography
phz: alephzero
pia: participialization
pib: discerpibleness
pic: pseudophilanthropically
pid: epididymodeferentectomy
pie: piezocrystallization
pif: archdapifership
pig: pharyngoepiglottidean
pih: epihydrinic
pii: idiosepiidae
pij: tapijulapane
pik: antiturnpikeism
pil: papilloadenocystoma
pim: stereocampimeter
pin: oophorosalpingectomy
pio: propionibacterieae
pip: parallelepipedonal
piq: piquantness
pir: hyperspiritualizing
pis: anopisthographically
pit: anticapitalistically
piu: carcinoscorpius
piv: chumpivilca
piw: topiwala
pix: pixilation
piz: epizootiologically
pja: skipjackly
pje: propjets
pjo: apjohnite
pka: wetumpka
pke: shopkeeperess
pkg: pkgs
pki: pumpkinification
pkn: stumpknocker
pks: pks
pkt: pkt
pkw: pkwy
pla: heterotransplantation
plb: plbroch
ple: plethysmographically
plf: staplf
pli: nonmultiplicational
plo: preterdiplomatically
plp: nauplplii
plt: pltano
plu: plutonometamorphism
ply: counterreplying
pma: midshipmanship
pme: counterdevelopment
pmi: propmistresses
pmk: pmk
pmo: stepmotherliness
pms: pmsg
pmt: appmt
pmu: chipmucks
pna: dermatopnagic
pnc: pnce
pne: hydropneumopericardium
pni: pyrostilpnite
pno: autohypnotization
pnu: sheepnut
pnx: pnxt
pny: ampelograpny
poa: hypoaminoacidemia
pob: anthrohopobiological
poc: anthropoclimatologist
pod: anthropodeoxycholic
poe: onomatopoetically
pof: adipofibroma
pog: anthropogeographical
poh: laparocolpohysterotomy
poi: granulocytopoiesis
poj: apojove
pok: hypokeimenometry
pol: polytetrafluoroethylene
pom: anthropomorphologically
pon: spondylotherapeutics
poo: dessertspoonfuls
pop: anthropophysiography
poq: apoquinamine
por: noncontemporaneousness
pos: counterexpostulation
pot: anthropoteleological
pou: asymmetrocarpous
pov: hypovitaminosis
pow: overpowerfulness
pox: chlordiazepoxide
poy: charpoys
poz: anthropozoic
ppa: appassionatamente
ppb: uppbad
ppd: appd
ppe: appendorontgenography
pph: sapphireberry
ppi: overhandicapping
ppl: nonapplicableness
ppm: appmt
ppn: suppnea
ppo: nonsupportableness
ppp: apppetible
ppr: overappreciativeness
pps: schlepps
ppt: apptd
ppu: postsuppurative
ppy: poppycockish
pqu: nepquite
pra: theoreticopractical
pre: superincomprehensibleness
prf: prf
pri: inappropriableness
prl: prlate
prn: prn
pro: desoxyribonucleoprotein
prp: prp
prs: prs
pru: jurisprudentialist
pry: hypsiprymnodontinae
psa: infralapsarianism
psb: corpsbruder
psc: rapscallionism
pse: pseudointernationalistic
psf: teacupsful
psh: slipshoddiness
psi: hypsidolichocephalism
psk: cheapskates
psl: slipsloppish
psm: scampsman
psn: snipsnapsnorum
pso: hypsobathymetric
psp: archespsporia
psq: pipsqueaks
psr: upsring
pss: pssimistical
pst: upstandingness
psu: microencapsulation
psw: upsweeping
psy: philosophicopsychological
pta: dimethyltryptamine
ptb: promptbooks
ptc: prebankruptcy
ptd: apptd
pte: archaeopterygiformes
ptf: contemptful
ptg: ptg
pth: opthalmothermometer
pti: orbiculatoelliptical
ptk: kemptken
ptl: circumscriptly
ptm: disruptment
ptn: noncorruptness
pto: microcryptocrystalline
ptp: ptp
ptr: calyptrimorphous
pts: bankruptship
ptt: overskeptticism
ptu: overpresumptuousness
ptw: scriptwriting
pty: palaeoptychology
pua: humuhumunukunukuapuaa
pub: aristorepublicanism
puc: pucciniaceous
pud: jackpuddinghood
pue: nonpuerilities
puf: powderpuff
pug: inexpugnableness
puh: awapuhi
pui: overpuissantly
puj: alpujarra
puk: pukishness
pul: facioscapulohumeral
pum: pumpkinification
pun: electropuncturation
pup: capsulopupillary
puq: puquinan
pur: nonpurchasability
pus: mechanicocorpuscular
put: electrotheraputically
puu: praecipuum
pux: puxy
puy: chachapuya
puz: puzzleheadedness
pva: upvalley
pvi: dropvie
pvo: upvomit
pvr: supvr
pvt: pvt
pwa: harpwaytuning
pwc: pwca
pwe: bishopweed
pwh: upwheel
pwi: scallopwise
pwo: worshipworthy
pwr: shipwrightery
pwt: pwt
pwy: expwy
pya: pyarthrosis
pyb: capybaras
pyc: heteropycnosis
pyd: copydesks
pye: ureteropyelonephritis
pyf: copyfitting
pyg: semicallipygian
pyh: copyholders
pyi: overpreoccupying
pyj: pyjamaed
pyk: desmopyknosis
pyl: isopropylideneacetone
pym: copyman
pyn: albespyne
pyo: pyopneumocholecystitis
pyp: spyproof
pyr: chlorprophenpyridamine
pys: puppysnatch
pyt: pythonomorphous
pyu: colipyuria
pyv: pyvuril
pyw: copywriters
pyx: pyxidanthera
pzi: leipzig
qab: qabbalah
qad: qadarite
qaf: qaf
qai: qaimaqam
qam: qaimaqam
qan: qanats
qas: qasidas
qat: sadaqat
qed: seqed
qen: seqence
qer: qere
qfc: seqfchk
qgy: penetrolqgy
qia: iraqian
qib: qibla
qid: qid
qil: inqilab
qin: qindarka
qir: faqirs
qis: iraqis
qiv: qiviuts
qiy: qiyas
qli: taqlid
qoh: qoheleth
qon: yaqona
qop: qophs
qpt: eqpt
qqu: zaqqum
qqv: qqv
qra: miqra
qrc: seqrch
qrs: hdqrs
qrt: sqrt
qsh: buqshas
qta: qtam
qtd: qtd
qti: negqtiator
qto: qto
qtr: qtr
qts: qts
qty: qty
qua: nonacquaintanceship
qub: qubba
qud: squdge
que: nonconsequentialness
quh: lonquhard
qui: benzofuroquinoxaline
qum: zaqqum
qun: qung
quo: aquopentamminecobaltic
quq: colloququia
qur: qurushes
qus: squshiest
quu: squushing
quv: equvalent
quy: amphoriloquy
qwe: beqwete
qwl: seqwl
raa: paraaminobenzoic
rab: tetrabromofluorescein
rac: demethylchlortetracycline
rad: microradiographically
rae: intraecclesiastical
raf: polytetrafluoroethylene
rag: subdiaphragmatically
rah: tetrahydrocannabinol
rai: tetraiodophenolphthalein
raj: extrajudicially
rak: tetrakaidecahedron
ral: antisupernaturalistic
ram: cyclotrimethylenetrinitramine
ran: pseudolamellibranchiata
rao: extraordinariness
rap: electroencephalographically
raq: hydroxyanthraquinone
rar: diphenylaminechlorarsine
ras: acetylcholinesterase
rat: regeneratoryregeneratress
rau: electrohydraulically
rav: antigravitationally
raw: withdrawingness
rax: hydropneumothorax
ray: unprayerfulness
raz: dinitrophenylhydrazine
rba: phenylthiocarbamide
rbb: interbbred
rbd: serbdom
rbe: superbelievableness
rbh: darbha
rbi: acetylmethylcarbinol
rbk: yrbk
rbl: superblessedness
rbm: perturbment
rbn: superbness
rbo: propanedicarboxylic
rbr: hyperbrachycephalic
rbs: curbstoner
rbt: absorbtion
rbu: overbumptiousness
rbw: barbwires
rby: carbylamine
rca: demarcatordemarcators
rcb: arcboutant
rcc: arccosine
rcd: rcd
rce: superceremoniousness
rcf: arcform
rcg: marcgraviaceous
rch: noninterchangeableness
rci: overcommercialization
rck: bismarckianism
rcl: counterclassifications
rcn: percnosome
rco: hyperconscientiousness
rcp: rcpt
rcr: intercrystallization
rcs: ectosarcs
rct: circumantarctic
rcu: circumparallelogram
rcv: rcvr
rcy: supercynicalness
rda: orbiculatocordate
rdb: standardbearers
rdc: wordcraftsman
rdd: shepherddom
rde: interdenominationalism
rdf: disregardfulness
rdg: swordgrass
rdh: hardheartedness
rdi: electrocardiographically
rdk: swordknot
rdl: westnorthwestwardly
rdm: coastguardman
rdn: unstraightforwardness
rdo: hyperdolichocephalic
rdp: wordprocessors
rdr: overdramatically
rds: outwardsoutwarred
rdt: barnhardtite
rdu: superarduousness
rdv: mordvinian
rdw: standardwise
rdy: sturdyhearted
rea: pancreaticoduodenostomy
reb: semirebelliousness
rec: blepharosphincterectomy
red: preinferredpreinferring
ree: threedimensionality
ref: counterreformation
reg: regeneratoryregeneratress
reh: superincomprehensibleness
rei: preinferredpreinferring
rej: unprejudicialness
rek: foreknowableness
rel: philosophicoreligious
rem: premisrepresentation
ren: epididymodeferentectomy
reo: preobtrudingpreobtrusion
rep: nonrepresentationalism
req: counterequivalent
rer: archtreasurership
res: regeneratoryregeneratress
ret: immunoelectrophoretically
reu: hypereuryprosopic
rev: counterrevolutionaries
rew: unforewarnedness
rex: counterexcommunication
rey: overeyebrowed
rez: prezygapophysial
rfa: hyperfastidiousness
rfb: surfboarding
rfc: surfcasting
rfd: serfdoms
rfe: interferometrically
rff: gersdorffite
rfg: orfgild
rfh: wharfholder
rfi: subsuperficialness
rfl: hyperflexibleness
rfm: surfmanship
rfn: dwarfness
rfo: superformidableness
rfp: surfperches
rfr: interfraternally
rfs: turfskiing
rfu: hyperfunctionally
rfv: arfvedsonite
rfw: scarfwise
rfy: dwarfy
rfz: rfz
rga: counterorganization
rge: overgesticulativeness
rgf: chargfaires
rgg: asperggilla
rgh: roxburghiaceae
rgi: anatomicochirurgical
rgk: schomburgkia
rgl: hyperglycorrhachia
rgm: bergmannite
rgn: lorgnettes
rgo: dihydroergotamine
rgr: hypergrammaticalness
rgs: brandenburgs
rgt: arrgt
rgu: overargumentativeness
rgw: burgware
rgy: electrometallurgy
rha: cholecystenterorrhaphy
rhb: rhb
rhd: rhd
rhe: dacryocystoblennorrhea
rhi: prorhipidoglossomorpha
rhm: burhmoot
rho: hemorrhoidectomies
rhs: catarrhs
rhu: superhumanizing
rhw: garhwali
rhy: macracanthrorhynchiasis
ria: antidisestablishmentarianism
rib: desoxyribonucleoprotein
ric: dichlorodiphenyltrichloroethane
rid: chlorprophenpyridamine
rie: counterrevolutionaries
rif: chlorotrifluoroethylene
rig: brigantinebrigantines
rih: trihemitetartemorion
rii: anthracotheriidae
rij: perijejunitis
rik: strikebreakers
ril: pseudosacrilegiously
rim: cyclotrimethylenetrinitramine
rin: cyclotrimethylenetrinitramine
rio: scleroticochorioiditis
rip: cholecystolithotripsy
riq: subtriquetrous
rir: counterirritation
ris: pseudoaristocratically
rit: ureteropyelonephritis
riu: propionibacterium
riv: hypophyseoprivous
riw: beperiwigged
rix: coadministratrix
riy: kshatriyahood
riz: hydrodesulphurization
rja: interjaculateded
rje: interjectionalising
rji: perjinkities
rjo: overjocularity
rju: superjustification
rka: unremarkableness
rkb: workbenches
rkc: barkcutter
rkd: clerkdoms
rke: nonmarketability
rkf: markfieldite
rkg: markgenossenschaft
rkh: darkheartedness
rki: internetworking
rkk: markkaa
rkl: farkleberries
rkm: workmanlikeness
rkn: afterknowledge
rko: turkophilism
rkp: sparkplugging
rkr: kulturkreis
rks: underclerkship
rkt: worktables
rku: burkundauze
rkw: workwomanlike
rky: patchworky
rla: overlasciviousness
rlb: hurlbarrow
rlc: girlchild
rld: otherworldliness
rle: counterlegislation
rlf: girlfriends
rlg: whirlgig
rlh: schoolgirlhood
rli: antiparliamentarians
rlk: erlkings
rll: girllikeness
rlm: whirlmagee
rlo: superlogicalities
rlp: whirlpools
rls: schoolgirls
rlt: tarltonize
rlu: superluxuriousness
rlw: whirlwindish
rly: nonperpendicularly
rma: formaldehydesulphoxylate
rmb: warmblooded
rmc: cirmcumferential
rme: archaeopterygiformes
rmf: charmfulness
rmg: armgaunt
rmh: warmheartedness
rmi: nondeterminativeness
rmk: barmkin
rml: noncruciformly
rmm: flittermmice
rmn: ununiformness
rmo: magnetothermoelectricity
rmp: reformproof
rmr: wormroots
rms: thunderstorms
rmt: warmthlessness
rmu: overmultiplication
rmw: charmwise
rmy: bronchomucormycosis
rna: pseudointernationalistic
rnb: hornblendophyre
rnc: archturncoat
rnd: corndodger
rne: overneglectfulness
rnf: overmournfulness
rng: cairngorum
rnh: stubbornhearted
rni: archconfraternities
rnk: underturnkey
rnl: slatternliness
rnm: antigovernmentally
rnn: antimodernness
rno: sternocleidomastoideus
rnp: antiturnpikeism
rnr: cornrick
rns: diminishingturns
rnt: sunburntness
rnu: supernumerariness
rnv: turnverein
rnw: cornwallises
rny: hornyhanded
roa: gastroenteroanastomosis
rob: aerobacteriologically
roc: hydroxydehydrocorticosterone
rod: dichlorodiphenyltrichloroethane
roe: dichlorodiphenyltrichloroethane
rof: semiprofessionalized
rog: electrophotomicrography
roh: photospectroheliograph
roi: thyroparathyroidectomize
roj: gastrojejunostomies
rok: sclerokeratoiritis
rol: dihdroxycholecalciferol
rom: dichlorodifluoromethane
ron: hydroxydehydrocorticosterone
roo: electroosmotically
rop: trinitrophenylmethylnitramine
roq: benzofuroquinoxaline
ror: macracanthrorhynchiasis
ros: microspectrophotometrically
rot: chlorotrifluoroethylene
rou: pseudoambidextrously
rov: incontrovertibleness
row: narrowheartedness
rox: hydroxydehydrocorticosterone
roy: pteroylglutamic
roz: heterozygousness
rpa: interparenthetically
rpb: sharpbill
rpe: nonperpendicularity
rph: anthropomorphologically
rpi: overpictorializing
rpl: hydrochlorplatinous
rpm: escarpments
rpn: oversharpness
rpo: hyperpolysyllabically
rpp: interppoliesh
rpr: chlorprophenpyridamine
rps: overpsychologizing
rpt: indiscerptibleness
rpu: mechanicocorpuscular
rpw: harpwaytuning
rpy: hyperpyrexial
rqu: overqualification
rra: mediterraneanization
rrb: dorrbeetle
rre: preinferredpreinferring
rrf: burrfishes
rrg: burrgrailer
rrh: cholecystenterorrhaphy
rri: preinferredpreinferring
rrk: burrknot
rrl: tirrlie
rrm: pirrmaw
rrn: garrnishable
rro: polyvinylpyrrolidone
rrr: brrr
rrs: burrstone
rrt: arrtez
rru: uninterruptibleness
rrw: churrworm
rry: unintermarrying
rsa: nonconversationally
rsb: hairsbreadths
rsc: hyperscholastically
rsd: gersdorffite
rse: oversentimentalizing
rsf: bakersfield
rsh: historiographership
rsi: diphenylaminechlorarsine
rsk: helterskelteriness
rsl: overslavishness
rsm: outdoorsmanship
rsn: persnicketiness
rso: hypersophistication
rsp: hyperspeculativeness
rsq: oversqueamishness
rss: intersshot
rst: oversuperstitiousness
rsu: oversuperstitiousness
rsv: rsvp
rsw: bittersweetness
rsy: oversystematicalness
rta: nonascertainableness
rtb: heartbreakingly
rtc: portcullising
rtd: sweetheartdom
rte: demethylchlortetracycline
rtf: slartibartfast
rtg: overmortgaging
rth: pseudoparthenogenesis
rti: hydroxydehydrocorticosterone
rtj: kwartje
rtl: comfortlessness
rtm: compartmentalization
rtn: frankheartness
rto: aphthartodocetism
rtp: dirtplate
rtq: heartquake
rtr: intertransformability
rts: unsportsmanlikeness
rtt: heartthrobs
rtu: imperturbableness
rtv: thortveitite
rtw: intertwinements
rty: martyrologistic
rtz: quartziferous
rua: pseudomenstruation
rub: undershrubbiness
ruc: interdestructiveness
rud: preobtrudingpreobtrusion
rue: pantagruelistical
ruf: rufoferruginous
rug: argilloferruginous
ruh: puruha
rui: nonaltruistically
ruj: brujeria
ruk: perukiership
rul: superultrafrostified
rum: noninstrumentalistic
run: superuniversalness
ruo: noncongruousness
rup: uninterruptibleness
ruq: perruquiers
rur: anatomicochirurgical
rus: preobtrudingpreobtrusion
rut: overbrutalization
ruu: intermenstruum
ruv: phosphoenolpyruvate
ruw: thruways
rux: truxilline
ruy: teruyuki
ruz: cruzadoes
rva: hyperconservativeness
rve: noninterventionalist
rvi: superserviceableness
rvk: corvktte
rvl: cooghneiorvlt
rvo: servomechanically
rvs: mirvs
rvu: pervulgation
rvy: ethchlorvynol
rwa: unstraightforwardness
rwd: crwd
rwe: counterweighing
rwh: overwhelmingness
rwi: overwillingness
rwo: otherworldliness
rwr: interwreathing
rwt: crwths
rwu: liverwursts
rww: interwwrought
rwy: frwy
rxi: procatarxis
rxy: interxylary
rya: mesembryanthemaceae
ryb: isocorybulbine
ryc: merycoidodontidae
ryd: dehydrocorydaline
rye: aryepiglottidean
ryf: butteryfingered
ryg: archaeopterygiformes
ryh: sorryhearted
ryi: unintermarrying
ryk: kerykeion
ryl: photophosphorylation
rym: hypsiprymnodontinae
ryn: glossolabiopharyngeal
ryo: dacryocystoblennorrhea
ryp: microcryptocrystalline
ryr: regeneratoryregeneratress
rys: microcryptocrystalline
ryt: erythrodegenerative
ryu: embryulculci
ryv: sherryvallies
ryw: everywhereness
ryx: anomalopteryx
ryz: oryzorictinae
rza: rinforzando
rzb: harzburgite
rze: superzealousness
rzi: bilharziasis
rzn: hrzn
rzo: interzooecial
rzr: arzrunite
rzu: zarzuelas
rzy: interzygapophysial
saa: saarbrucken
sab: indecomposableness
sac: heteropolysaccharide
sad: predisadvantageously
sae: odontoglossae
saf: disafforestation
sag: supersagaciousness
sah: triakisicosahedral
sai: unassailableness
saj: tasajillos
sak: forsakenness
sal: oophorosalpingectomy
sam: dimethylnitrosamine
san: counterreconnaissance
sao: mesaortitis
sap: misapprehensiveness
saq: transaquatic
sar: tessarescaedecahedron
sas: nondisastrousness
sat: transcendentalisation
sau: misauthorization
sav: savorlessness
saw: handsawfishes
sax: saxifragaceous
say: soothsayership
saz: conversaziones
sba: amphisbaenidae
sbb: crossbbred
sbe: misbecomingness
sbi: scissorsbird
sbl: glassblowers
sbo: poluphloisboiotatotic
sbr: crossbreeding
sbu: nondisbursement
sby: archpresbyterate
sca: tessarescaedecahedron
scc: scclera
sce: crystalloluminescence
scf: scfh
sch: pseudoscholastically
sci: scientificophilosophical
scl: scleroticochorioiditis
scm: mtscmd
scn: oscnode
sco: stereomicroscopically
scr: overdiscriminatingly
scs: videodiscs
sct: sctd
scu: mechanicocorpuscular
scy: pseudohyoscyamine
sda: disdainfulness
sde: disdenominationalize
sdi: transdiaphragmatic
sdl: sdlc
sdn: isdn
sdo: dyakisdodecahedron
sdr: eavesdroppers
sds: sds
sdu: cotransduction
sdy: electrogasdynamics
sea: nonseasonableness
seb: housebrokenness
sec: antivivisectionists
sed: dynamometamorphosed
see: unforeseeableness
sef: housefurnishings
seg: transsegmentally
seh: falseheartedness
sei: microseismometrograph
sej: sejunctively
sek: housekeeperlike
sel: selectivitysenescence
sem: semianthropologically
sen: nonrepresentationalism
seo: osseocartilaginous
sep: superseptuaginarian
seq: nonconsequentialness
ser: hyperconservativeness
ses: antidisestablishmentarianism
set: dentatosetaceous
seu: pseudointernationalistic
sev: unperseveringness
sew: praiseworthiness
sex: transexperiential
sey: puseyistical
sez: sezession
sfa: dissatisfactoriness
sfd: transfd
sfe: countertransference
sfi: unsatisfiableness
sfl: breechesflower
sfm: sfm
sfo: intertransformability
sfr: disfranchisements
sfu: semisuccessfully
sfy: unsatisfyingness
sfz: sfz
sga: billingsgate
sgd: asgd
sge: transgenerations
sgh: lesgh
sgi: misgivinglying
sgl: bisglyoxaline
sgm: asgmt
sgn: demesgnes
sgo: misgovernance
sgr: nontransgressively
sgu: undisguisedness
sgy: misgye
sha: nondistinguishableness
shb: swashbucklerdom
shc: cashcuttee
shd: splashdowns
she: snailfishessnailflower
shf: overbashfulness
shg: mashgichim
shh: mushheadedness
shi: historiographership
shj: brainwashjng
shk: narrishkeit
shl: pseudoamateurishly
shm: antidisestablishmentarianism
shn: schoolmasterishness
sho: dishonourableness
shp: semiflashproof
shq: fleshquake
shr: undershrubbiness
shs: kedushshah
sht: taltushtuntude
shu: transhumanation
shv: ashvamedha
shw: crashworthiness
shy: bishydroxycoumarin
sia: pseudoenthusiastically
sib: superincomprehensibleness
sic: theologicometaphysical
sid: hypsidolichocephalism
sie: nontransientness
sif: counterclassifications
sig: ureterosigmoidostomy
sih: hexacosihedroid
sii: edwardsiidae
sij: quasijudicial
sik: scheltopusik
sil: pharyngotonsillitis
sim: overpessimistically
sin: diphenylaminechlorarsine
sio: preobtrudingpreobtrusion
sip: hypsiprymnodontinae
siq: physiqued
sir: overdesirousness
sis: gastroenteroanastomosis
sit: superinquisitiveness
siu: organomagnesium
siv: noncomprehensiveness
siw: siwashing
six: sixpennyworth
siy: lesiy
siz: photosynthesizing
sja: crossjack
sje: disjecting
sji: masjids
sjo: disjointedness
sju: nondisjunctional
ska: triskaidekaphobes
skb: whiskbroom
ske: helterskelteriness
skf: riskfulness
skg: muskgrass
skh: muskhogean
ski: threskiornithidae
skj: hlidhskjalf
skl: aeolsklavier
skm: taskmastership
skn: misknowledge
sko: anagignoskomena
skp: riskproof
skr: sanskritization
sks: tasksetting
skt: tsktsking
sku: numskulledness
skw: kuskwogmiut
sky: razoumofskya
sla: counterlegislation
sld: sld
sle: sledgehammering
slf: fosslfying
sli: businesslikeness
sll: dislluminate
slo: translocalization
sls: isls
slt: juslted
slu: demitranslucence
sly: hyperconscientiously
sma: magnetoplasmadynamics
smd: ismdom
sme: disestablismentarianism
smh: hecchsmhaer
smi: blepharosyndesmitis
sml: schismless
smm: taysmm
smn: dysmnesia
smo: microseismometrograph
smp: sarcasmproof
smr: dharmasmriti
sms: anthropomorphisms
smu: untransmutableness
smy: homoplasmy
sna: snailfishessnailflower
sne: hyperconscientiousness
sni: pecksniffianism
sno: snipsnapsnorum
sns: coisns
snt: doesnt
snu: candlesnuffer
sny: snyaptic
soa: chrysoaristocracy
sob: azoisobutyronitrile
soc: anthroposociologist
sod: spinulosodenticulate
soe: glossoepiglottidean
sof: lissoflagellata
sog: spinulosogranulate
soh: chrysohermidin
soi: dispersoidological
soj: sojournment
sok: glossokinesthetic
sol: glossolabiopharyngeal
som: astrospherecentrosomic
son: dispersonification
soo: contrabassoonist
sop: philosophicopsychological
soq: isoquercitrin
sor: mandibulosuspensorial
sos: epididymovasostomy
sot: spinosotuberculate
sou: outwardsoutwarred
sov: transversovertical
sow: cassowaries
sox: hydroxydesoxycorticosterone
soy: isoyohimbine
soz: squamosozygomatic
spa: semitransparentness
spb: raspberrylike
spc: aspca
spe: microspectrophotometrically
spf: reichspfennig
spg: tetraspgia
sph: blepharosphincterectomy
spi: spinulosodenticulate
spl: heterotransplantation
spn: waspnesting
spo: spondylotherapeutics
spp: spp
spr: disproportionableness
sps: archespsporia
spt: claspt
spu: nondisputatiousness
spy: counterspying
sqd: sqd
sqq: sqq
sqr: sqrt
squ: squamatotuberculate
sra: transrationally
sre: premisrepresentation
srh: transrhodanian
sri: transriverina
sro: extraclassroom
srs: messrs
sru: nondisruptingly
sry: harnessry
ssa: counterreconnaissance
ssb: crossbreeding
ssc: superinsscribing
ssd: governessdom
sse: unprepossessingness
ssf: crossfertilizable
ssg: crossgrainedness
ssh: headmistressship
ssi: counterclassifications
ssj: crossjack
ssk: masskanne
ssl: businesslikeness
ssm: disembarrassment
ssn: snailfishessnailflower
sso: prorhipidoglossomorpha
ssp: dysspermatism
ssq: grassquit
ssr: extraclassroom
sss: headmistressship
sst: stegnosisstegnotic
ssu: fideicommissumissa
ssv: promissvry
ssw: grasswidowhood
ssy: dissyllabification
sta: antidisestablishmentarianism
stb: postbaptismal
stc: postcartilaginous
std: postdevelopmental
ste: hydroxydehydrocorticosterone
stf: undistrustfulness
stg: cholecystgastrostomy
sth: anopisthographically
sti: pseudointernationalistic
stj: postjugular
stk: chistka
stl: postlegitimation
stm: postmillenarianism
stn: cholecystnephrostomy
sto: gastroenteroanastomosis
stp: postpathological
str: gastroenteroanastomosis
sts: antienvironmentalists
stt: posttubercular
stu: counterexpostulation
stv: postvocalically
stw: westnorthwestwardly
stx: postxiphoid
sty: dermatoheteroplasty
stz: postzygapophyseal
sua: impersuadableness
sub: transubstantiationalist
suc: succinylsulphathiazole
sud: sudoriferousness
sue: consuetudinary
suf: nonsufferableness
sug: hypersuggestibleness
suh: susuhunan
sui: noncasuistically
suj: suji
suk: mitsukurinidae
sul: formaldehydesulphoxylate
sum: overpresumptuousness
sun: unmisunderstandable
suo: hypersensuousness
sup: superincomprehensibleness
suq: tesuque
sur: antiinsurrectionally
sus: mandibulosuspensorial
sut: subhirsuteness
suu: sadalsuud
suv: krisuvigite
suw: katsuwonidae
sux: sulfasuxidine
suy: chinchasuyu
suz: suzerainship
sva: transvaluation
svc: svce
sve: intertransversalis
svg: svgs
svi: charlottesville
svo: transvolation
svp: rsvp
svr: promissvry
svu: disvulnerability
swa: swashbucklerdom
swe: swedenborgianism
swi: grasswidowhood
swl: swleaves
swo: draughtswomanship
swr: sportswriters
swu: outswung
swy: swythe
sya: debussyanize
syb: quinsyberries
syc: philosophicopsychological
syd: xanthopsydracia
sye: leucosyenite
syf: pussyfooting
syg: easygoingness
syh: gipsyhead
syi: courtesying
syk: psykters
syl: hyperpolysyllabically
sym: arteriosympathectomy
syn: electrosynthetically
syo: disyoking
syp: heredosyphilitic
syr: dacryocystosyringotomy
sys: oversystematicalness
syt: topsyturviness
syu: dasyuridae
syv: arsyversy
syw: dropsywort
syz: syzygetically
sza: szaibelyite
sze: miszealous
szi: casziel
szk: friszka
szl: szlachta
szo: miszoning
szt: krzysztof
szy: groszy
taa: staatsraad
tab: antidisestablishmentarianism
tac: metacarpophalangeal
tad: dicyclopentadienyliron
tae: voltaelectrometric
taf: metaformaldehyde
tag: predisadvantageously
tah: dishexecontahedroid
tai: nonascertainableness
taj: huantajayite
tak: octakishexahedron
tal: microcryptocrystalline
tam: aquopentamminecobaltic
tan: transubstantiationalist
tao: metaorganism
tap: theologicometaphysical
taq: chontaquiro
tar: antidisestablishmentarianism
tas: phantasmagorically
tat: nonrepresentationalism
tau: electrotautomerism
tav: palaeoatavistic
taw: catawamptiously
tax: chemotaxonomically
tay: forestaysail
taz: phenylbutazone
tba: carpetbaggery
tbb: outbbled
tbd: stbd
tbe: rabbitberries
tbi: frostbiting
tbl: outbleating
tbo: outboundaries
tbr: heartbreakingly
tbs: tbssaraglot
tbu: distritbuting
tby: courtby
tca: postcartilaginous
tce: postcerebellar
tch: featherstitching
tci: empiriocritcism
tck: concertstck
tcl: postclassicism
tco: postconvalescents
tcr: antipriestcraft
tcu: portcullising
tcy: prebankruptcy
tcz: itcze
tda: outdaciousness
tdd: stddmp
tde: postdevelopmental
tdi: postdiaphragmatic
tdo: outdoorsmanship
tdr: outdreaming
tdu: postdural
tdw: outdwelling
tdy: postdysenteric
tea: cholesteatomatous
teb: intervertebrally
tec: epididymodeferentectomy
ted: interdifferentiated
tee: antiparliamenteer
tef: overgratefulness
teg: syncategorematically
teh: antehypophysis
tei: desoxyribonucleoprotein
tej: antejentacular
tek: teknonymously
tel: overintellectualization
tem: noncontemporaneousness
ten: cholecystenterorrhaphy
teo: palaeometeorological
tep: preantepenultimate
teq: outequivocating
ter: hydroxydehydrocorticosterone
tes: alkylbenzenesulfonates
tet: demethylchlortetracycline
teu: pseudoamateurishly
tev: protevangelion
tew: understewardship
tex: directexamination
tey: brighteyes
tez: courtezanship
tfa: crestfallenness
tfd: getfd
tfe: breastfeeding
tff: outffed
tfi: tightfistedness
tfl: blanketflower
tfo: unstraightforwardness
tfr: thoughtfreeness
tfu: forethoughtfulness
tga: cholecystgastrostomy
tge: appendorontgenography
tgi: outgiving
tgl: postglenoidal
tgn: outgnawing
tgo: montgomeryshire
tgr: postgraduates
tgt: tgt
tgu: coastguardsman
tha: dichlorodiphenyltrichloroethane
thb: sabbathbreaking
thc: forthcomingness
thd: withdrawingness
the: magnetothermoelectricity
thf: overfaithfulness
thg: earthgrubber
thh: unwithholding
thi: succinylsulphathiazole
thk: sabbathkeeping
thl: encephalothlipsis
thm: autopsychorhythmia
thn: ethnomusicologically
tho: pathologicopsychological
thp: unmouthpieced
thq: preearthquake
thr: anthropomorphologically
ths: unhealthsomeness
tht: breathtakingly
thu: pseudoenthusiastically
thv: bathvillite
thw: westnorthwestwardly
thy: cyclotrimethylenetrinitramine
tia: transubstantiationalist
tib: hypersuggestibleness
tic: hydroxydehydrocorticosterone
tid: antidisestablishmentarianism
tie: antienvironmentalists
tif: scientificophilosophical
tig: antigrammaticalness
tih: antihierarchically
tii: antiinstitutionalists
tij: multijugate
tik: antiketogenesis
til: membranocartilaginous
tim: antimaterialistically
tin: pericardiomediastinitis
tio: pseudointernationalistic
tip: antiparliamentarians
tiq: unantiquatedness
tir: antirevolutionaries
tis: pericardiomediastinitis
tit: deinstitutionalization
tiu: antiutilitarianism
tiv: blepharoconjunctivitis
tiw: attiwendaronk
tix: antixerophthalmic
tiy: pratiyasamutpada
tiz: heterochromatization
tja: straightjacket
tjc: neritjc
tje: koggelmannetje
tji: outjinxing
tjo: outjourneying
tju: outjuggling
tka: hecctkaerre
tke: wicketkeeping
tki: outkicking
tkn: pocketknives
tko: vetkousie
tks: gitksan
tkt: tkt
tku: proletkult
tla: transatlantically
tle: ungentlemanlikeness
tlg: stlg
tli: auldfarrantlike
tll: outlled
tln: tln
tlo: occipitoatloid
tlr: tlr
tls: conepatls
tlu: postludium
tly: supersuperabundantly
tma: subpostmastership
tme: compartmentalization
tmh: millimetmhos
tmi: postmillenarianism
tmj: getmjlkost
tmm: nachtmml
tmo: nonatmospherically
tmu: postmultiplying
tmy: postmyxedematous
tna: acetnaphthalide
tnc: ftncmd
tne: supertranscendentness
tng: tng
tni: lightningproof
tnl: intnl
tno: westnorthwestwardly
tnp: tnpk
tnr: minatnrial
tnt: attntrp
tnu: postnuptially
toa: photoautotrophically
tob: dacryocystoblennorrhea
toc: microcryptocrystalline
tod: cholecystoduodenostomy
toe: orbiculatoelliptical
tof: magnetofluidmechanics
tog: cholecystogastrostomy
toh: magnetohydrodynamically
toi: sternocleidomastoideus
toj: cholecystojejunostomy
tok: phosphofructokinase
tol: pathologicohistological
tom: microspectrophotometrically
ton: cholecystonephrostomy
too: misunderstoodness
top: aminoacetophenetidine
toq: ovatoquadrangular
tor: regeneratoryregeneratress
tos: hematospectrophotometer
tot: magnetothermoelectricity
tou: protobasidiomycetous
tov: prostatovesiculectomy
tow: nonplantowning
tox: heterointoxication
toy: chatoyance
toz: photozincographic
tpa: postpathological
tpd: tpd
tpe: postpericardial
tpf: setpfx
tph: photphotonegative
tpi: pinoutpinpatch
tpk: tpke
tpl: breastplates
tpm: tpm
tpn: postpneumonic
tpo: postpositionally
tpr: postpredicament
tps: ecblastpsis
tpu: postpubescent
tpy: postpyramidal
tqu: outquibbling
tra: cyclotrimethylenetrinitramine
trc: epitrchelia
trd: tetrdra
tre: regeneratoryregeneratress
trf: trf
trh: postrheumatic
tri: dichlorodiphenyltrichloroethane
trl: unintrlined
trn: arbtrn
tro: trinitrophenylmethylnitramine
trp: attntrp
trs: tetrsyllabical
trt: elytrtra
tru: preobtrudingpreobtrusion
try: microspectrophotometry
tsa: outsatisfying
tsb: draughtsboard
tsc: bretschneideraceae
tse: semisightseeing
tsf: bucketsful
tsh: superintendentship
tsi: shortsightedness
tsj: mutsje
tsk: outskirmisher
tsl: footslogging
tsm: unsportsmanlikeness
tsn: gnatsnapper
tso: outsophisticating
tsp: dessertspoonfuls
tsr: staatsraad
tss: tss
tst: outstandingness
tsu: outsuperstition
tsv: mitsvahs
tsw: draughtswomanship
tsy: postsynaptically
tta: superattainableness
ttb: mattboard
ttd: plattdeutsch
tte: nonintermittentness
ttf: gottfried
ttg: buttgenbachite
tth: postthyroidal
tti: pharyngoepiglottidean
ttj: gyttja
ttl: counterembattled
ttm: committment
ttn: buettneriaceae
tto: glottochronological
ttr: counterattractively
tts: rickettsialpox
ttt: outttore
ttu: quattuordecillionth
ttv: boddhisattva
ttw: bodhisattwa
tty: outtyrannizing
tua: overintellectualization
tub: scrofulotuberculous
tuc: stucturelessness
tud: unplatitudinousness
tue: microconstituent
tuf: stuffgownsman
tug: portugalism
tuh: tzutuhil
tui: panhypopituitarism
tuk: kotukutuku
tul: counterexpostulation
tum: noncontumaciousness
tun: mishikhwutmetunne
tuo: overpresumptuousness
tup: unvituperativeness
tuq: otuquian
tur: antisupernaturalistic
tus: subsultorysubsultus
tut: deinstitutionalization
tuu: fortuuned
tuv: insistuvree
tuw: tuwi
tux: patuxent
tuy: tuyuneiri
tuz: tuzzle
tva: postvaricellar
tve: postvertebral
tvi: outvillage
tvo: outvociferating
tvy: outvying
twa: westnorthwestwardly
twe: twelvehyndeman
twh: cartwheeler
twi: countercurrentwise
two: counterbreastwork
twp: twp
twr: cartwrighting
twu: blutwurst
tww: outwwoven
twy: twyblade
txi: postxiphoid
txt: txt
txy: postxyphoid
tya: acerbityacerose
tyb: platybrachycephalous
tyc: tychoparthenogenesis
tyd: platydolichocephalous
tye: immensittye
tyf: twentyfourmo
tyg: platyglossate
tyh: platyhelminthes
tyi: unpityingness
tyk: platykurtosis
tyl: pseudomonocotyledonous
tym: pseudoetymologically
tyn: tyndallization
tyo: palaeodictyopterous
typ: palaeotypographical
tyq: triptyque
tyr: azoisobutyronitrile
tys: selectivitysenescence
tyt: thirtytwomo
tyu: sarcodictyum
tyw: ladylintywhite
tyx: anaptyxes
tza: quetzalcoatl
tzb: blitzbuggy
tzc: fitzclarence
tze: politzerization
tzf: spitzflute
tzi: leibnitzianism
tzk: blitzkrieging
tzl: quartzless
tzm: kreitzman
tzn: kibbutznik
tzo: tezcatzoncatl
tzp: chutzpadik
tzr: fitzroya
tzs: nietzscheanism
tzu: dashnaktzutiun
tzv: mitzvahs
tzy: postzygapophyseal
uaa: humuhumunukunukuapuaa
uab: nonconstruability
uac: nonsequaciousness
uad: quadratomandibular
uae: acuaesthesia
uaf: aquafortist
uag: superseptuaginarian
uah: chihuahuas
uai: nonacquaintanceship
uaj: araquaju
uak: preearthquake
ual: overindividualistically
uam: squamatotuberculate
uan: nonquantitativeness
uao: guaraguao
uap: humuhumunukunukuapuaa
uaq: quaquaversally
uar: quartermasterlike
uas: impersuasibleness
uat: quattuordecillionth
uau: sinuauricular
uav: hemidemisemiquaver
uaw: squawberries
uax: guaxima
uay: paraguayans
uaz: alguazil
uba: subadministratively
ubb: subbrachycephalic
ubc: nonsubconsciousness
ubd: subdiaphragmatically
ube: scrofulotuberculous
ubf: subformativeness
ubg: subgelatinization
ubh: subhemispherically
ubi: aquintocubitalism
ubj: subjectivoidealistic
ubk: subkingdoms
ubl: aristorepublicanism
ubm: submicroscopically
ubn: subnutritiousness
ubo: insubordinateness
ubp: subpostmastership
ubq: subquadrangular
ubr: nonlubriciousness
ubs: transubstantiationalist
ubt: subtransparentness
ubu: subumbelliferous
ubv: nonsubversiveness
ubw: subwardenship
uby: rubythroat
ubz: subzygomatic
uca: pseudoeducationally
ucb: lucban
ucc: succinylsulphathiazole
ucd: ducdame
uce: unproduceableness
ucg: eucgia
uch: counteravouchment
uci: saccharomucilaginous
uck: chuckleheadedness
ucl: desoxyribonucleoprotein
ucn: eucnemidae
uco: bronchomucormycosis
ucp: uucpnet
ucr: semibureaucratically
ucs: barleducs
uct: counterproductiveness
ucu: cucurbitaceous
ucy: thucydidean
uda: antifeudalization
udb: cloudberries
udc: mudcapping
udd: muddleheadedness
ude: jurisprudentialist
udf: chaudfroid
udg: unbudgeableness
udh: pseudhalteres
udi: preobtrudingpreobtrusion
udl: cloudlessness
udm: defraudment
udn: overproudness
udo: pseudointernationalistic
udp: fraudproof
udr: pneudraulic
uds: ombudsmanship
udt: mudtrack
udu: nonfraudulently
udw: cloudwards
udy: palaeeudyptes
udz: budzart
uea: oversqueamishness
ueb: borasqueborate
uec: quinquecentenary
ued: quinquedentated
uee: intersqueezing
uef: quinquefoliolate
ueg: quinquegrade
ueh: trueheartedness
uei: recueillement
uej: quinquejugous
uel: pantagruelistical
uem: disemboguement
uen: nonconsequentialness
ueo: terraqueousness
uep: quinquepartition
uer: schopenhauereanism
ues: unquestionableness
uet: quinquetuberculate
ueu: plastiqueurs
uev: quinquevalvular
uew: agueweeds
uex: teguexin
uey: cliqueyness
uez: rodriguez
ufa: nonmanufacturing
ufb: lufberry
ufe: luteorufescent
uff: nonsufferableness
ufg: aufgabe
ufi: anthrarufin
ufk: aufklarung
ufl: semigenuflection
ufo: rufoferruginous
ufr: usufructuaries
ufs: langlaufs
uft: tufthunting
ufu: rufulous
ufy: argufying
uga: ultracentrifugation
ugb: willugbaeya
ugd: plugdrawer
uge: ultracentrifuged
ugf: slugfests
ugg: hypersuggestibleness
ugh: forethoughtfulness
ugi: argilloferruginous
ugk: neugkroschen
ugl: zeuglodontidae
ugm: nonaugmentative
ugn: inexpugnableness
ugo: zeugobranchiata
ugp: bugproof
ugr: beaugregories
ugs: shutterbugs
ugt: zugtierlaster
ugu: nonlugubriousness
ugw: archmugwump
ugy: rougy
ugz: zugzwang
uha: muhammadanism
uhe: euhemeristically
uhi: bauhinias
uhl: muhlenbergia
uhn: lieberkuhn
uho: seiyuhonto
uhr: kiesselguhr
uhs: uhs
uht: uhtensang
uhu: humuhumunukunukuapuaa
uhw: gluhwein
uhy: euhyostylic
uia: semicolloquially
uib: equibiradiate
uic: quicksilverishness
uid: magnetofluidmechanics
uie: nonacquiescently
uif: aquifoliaceous
uig: inequigranular
uih: sesquihydrated
uii: quiinaceous
uij: equijacent
uik: suikerbosch
uil: disequilibration
uim: equimolecular
uin: benzofuroquinoxaline
uio: overobsequiousness
uip: equiproportionality
uiq: colloquiquiums
uir: squirrelsstagnate
uis: nondistinguishableness
uit: counteracquittance
uiu: colloquiquiums
uiv: counterequivalent
uix: unquixotically
uiz: soliloquizingly
uja: hallelujatic
ujd: foujdarry
uje: brujeria
uji: cucujidae
ujo: beaujolais
ujr: gujrati
ujt: mujtahid
uju: jiujutsus
ujy: thujyl
uka: unrebukable
ukb: hukbalahap
ukc: chukchi
ukd: talukdari
uke: joukerypawkery
ukh: doukhobor
uki: kalymmaukion
ukk: dukkeripen
ukl: inguklimiut
uko: hyperleukocytosis
ukp: paukpan
ukr: ukrainians
uks: merribauks
ukt: euktolite
uku: humuhumunukunukuapuaa
uky: chalukyan
ula: overgesticulativeness
ulb: laboulbeniaceous
ulc: ulceromembranous
uld: auldfarrantlike
ule: prostatovesiculectomy
ulf: alkylbenzenesulfonates
ulg: caprimulgiformes
ulh: soulhealth
uli: electrohydraulically
ulk: overbulkiness
ull: periosteomedullitis
ulm: branchiopulmonata
uln: forethoughtfulness
ulo: pneumoventriculography
ulp: formaldehydesulphoxylate
ulq: pulques
ulr: bulrushlike
uls: electroconvulsive
ult: ultranationalistically
ulu: counterstimulus
ulv: pulverableness
ulw: mussulwoman
ulx: faulx
uly: multituberculy
ulz: brulzies
uma: electropneumatically
umb: circumbendibuses
umc: uncircumcisedness
umd: circumdenudation
ume: overargumentativeness
umf: semicircumferentor
umg: circumgestation
umh: circumhorizontal
umi: crystalloluminescence
umj: circumjacencies
umk: naumkeager
uml: circumlocutionary
umm: nostrummongership
umn: circumnavigations
umo: hydropneumopericardium
ump: overpresumptuousness
umq: circumquaque
umr: circumradiuses
ums: circumstantiability
umt: circumterrestrial
umu: humuhumunukunukuapuaa
umv: semicircumvolution
umw: teetotumwise
umy: pseudocumyl
umz: circumzenithal
una: unaccommodatingness
unb: unbureaucratically
unc: blepharoconjunctivitis
und: undistinguishableness
une: unextinguishableness
unf: unfaithworthiness
ung: ungentlemanlikeness
unh: unhomogeneousness
uni: counterexcommunication
unj: unjustifiableness
unk: unknowledgeable
unl: unlexicographically
unm: unmaterialistically
unn: unnationalistically
uno: immunoelectrophoretically
unp: unproportionableness
unq: unquestionableness
unr: unrepresentativeness
uns: unstraightforwardness
unt: counterclassifications
unu: humuhumunukunukuapuaa
unv: unvituperativeness
unw: unwarrantableness
unx: quincunxial
uny: unyachtsmanlike
unz: unzealousness
uoa: fluoaluminate
uob: hydrofluoboric
uoc: aquocapsulitis
uod: pancreaticoduodenostomy
uog: linguogingival
uoh: borofluohydric
uoi: turquoiseberry
uok: visuokinesthetic
uol: trinitrotoluol
uom: skeuomorphic
uon: quondamship
uoo: menstruoos
uop: aquopentamminecobaltic
uoq: tuquoque
uor: chlorotrifluoroethylene
uos: hydrofluosilicate
uot: duotriacontane
uou: overpresumptuousness
uov: linguoversion
uow: pishquow
uoy: nonbuoyantly
uoz: hydrofluozirconic
upa: overpreoccupation
upb: unupbraidingly
upc: loupcerviers
upd: unupdated
upe: superincomprehensibleness
upf: kupfernickel
upg: upgathering
uph: poluphloisboiotatotic
upi: concupiscibleness
upj: upjerk
upk: upkindle
upl: photoduplication
upm: oneupmanship
upn: growingupness
upo: eupomatiaceae
upp: immunosuppressants
upq: upquiver
upr: ethylhydrocupreine
ups: upstandingness
upt: uninterruptibleness
upu: lupuserythematosus
upv: upvalley
upw: stirrupwise
upy: overpreoccupying
uqs: buqshas
uqu: fouquieriaceous
ura: antisupernaturalistic
urb: turbinatocylindrical
urc: nonpurchasability
urd: nonburdensomeness
ure: phenylethylmalonylurea
urf: furfuraceously
urg: anatomicochirurgical
urh: neighbourhood
uri: hydrodesulphurization
urj: surjection
urk: turkification
url: unneighbourliness
urm: insurmountableness
urn: nonjournalistically
uro: benzofuroquinoxaline
urp: semipurposiveness
urq: turquoiseberry
urr: antiinsurrectionally
urs: hyperexcursiveness
urt: overcourteousness
uru: sanguinopurulent
urv: recurvirostridae
urw: deurwaarder
ury: hypereuryprosopic
urz: mangelwurzel
usa: counteraccusation
usb: househusbands
usc: mechanicocorpuscular
usd: phousdar
use: lupuserythematosus
usf: argusfishes
usg: ausgespielt
ush: noncrushability
usi: preobtrudingpreobtrusion
usj: musjids
usk: huskershredder
usl: hyperconscientiously
usm: proceleusmatic
usn: hyperconscientiousness
uso: occlusocervically
usp: mandibulosuspensorial
usq: plusquamperfect
usr: costusroot
uss: electropercussive
ust: overindustrialization
usu: deorusumduction
usv: anusvara
usw: colossuswise
usy: interjealousy
usz: puszta
uta: nondisputatiousness
utb: outbargaining
utc: hutchinsonianism
utd: outdoorsmanship
ute: electrocauterization
utf: preoutfitting
utg: outgeneralling
uth: antiauthoritarianism
uti: counterrevolutionaries
utj: outjourneying
utk: outkeeping
utl: devoutlessness
utm: mishikhwutmetunne
utn: overdevoutness
uto: nonautobiographically
utp: pratiyasamutpada
utq: outquibbling
utr: overneutralization
uts: outsophisticating
utt: muttonheadedness
utu: pseudomutuality
utv: outvociferating
utw: outwardsoutwarred
uty: azoisobutyronitrile
utz: chutzpadik
uua: continuua
uub: ucuuba
uuc: uucpnet
uud: sadalsuud
uul: incunabuulum
uum: intermenstruum
uun: weltanschauungen
uur: zuurveldt
uus: smectymnuus
uut: busuuti
uva: phosphoenolpyruvate
uve: semperjuvenescent
uvi: fluvioterrestrial
uvl: souvlaki
uvo: subnuvolar
uvr: maneuvrability
uvu: uvulectomies
uvv: uvver
uvy: pyruvyl
uwa: ahluwalia
uwb: blauwbok
uwe: souwester
uwi: lauwines
uwl: pyruwl
uwo: katsuwonidae
uws: vrouws
uxa: semiluxation
uxb: buxbaumiaceae
uxe: bradyauxetically
uxg: fluxgraph
uxh: vauxhallian
uxi: confluxibleness
uxl: huxleian
uxm: fluxmeter
uxo: unuxoriousness
uxr: fluxroot
uxs: clarenceuxship
uxt: juxtaterrestrial
uxu: superluxuriousness
uxw: fluxweed
uxy: druxy
uya: unbuyableness
uyb: buybacks
uyd: guydom
uye: rocouyenne
uyg: huyghenian
uyh: houyhnhnm
uyi: underbuying
uyk: duyker
uyl: toluylenediamine
uyn: hauynophyre
uyo: thuyopsis
uys: underbuys
uyt: treckschuyt
uyu: ahantchuyuk
uyw: guywire
uza: douzainier
uzb: uzbak
uzc: cuzceno
uze: suzerainship
uzh: muzhiks
uzi: cruzieros
uzj: muzjiks
uzl: hakenkreuzler
uzm: guzmania
uzo: bouzoukia
uzu: kabuzuchi
uzv: huzvaresh
uzw: chuzwi
uzy: buzylene
uzz: puzzleheadedness
vaa: transvaalian
vab: superbelievableness
vac: antivaccinationist
vad: interpervading
vae: conjunctivae
vaf: vafrous
vag: vagoglossopharyngeal
vah: yeshivahs
vai: interavailability
vaj: vajrasana
vak: czechoslovakians
val: superchivalrousness
vam: sublevaminous
van: electrogalvanization
vao: gervao
vap: evapotranspiration
vaq: vaqueros
var: ovariosalpingectomy
vas: epididymovasostomy
vat: hyperconservativeness
vau: vaucheriaceous
vav: papovavirus
vaw: vawards
vax: microvaxes
vay: galvayning
vaz: kevazingo
vce: svce
vch: devchar
vci: stokavci
vda: havdalahs
vdi: cavdia
vdo: slavdom
vdp: avdp
vea: dissolveability
veb: noveboracensis
vec: vectorcardiographic
ved: coevolvedcoevolves
vee: unveeringly
vef: behoovefulness
veg: vegetocarbonaceous
veh: overvehementness
vei: interveining
vej: arvejon
vek: cavekeeper
vel: overrepresentatively
vem: novemdecillionth
ven: omnirepresentativeness
veo: pelveoperitonitis
vep: twelvepence
veq: eveque
ver: overindividualistically
ves: prostatovesiculectomy
vet: overcovetousness
veu: trouveurs
vev: reveverberatory
vew: gravewards
vex: nonvexatiousness
vey: conveyorization
vez: suivez
vga: avgasses
vgh: tavghi
vgs: svgs
via: imperviableness
vib: vibratiunculation
vic: superserviceableness
vid: overindividualistically
vie: subservientness
vif: revivification
vig: circumnavigations
vih: claviharp
vii: gaviiformes
vij: zavijava
vik: barkevikitic
vil: hypercivilization
vim: microgravimetric
vin: polyvinylpyrrolidone
vio: overlasciviousness
vip: nonviviparousness
viq: viqueen
vir: antienvironmentalists
vis: antivivisectionists
vit: blepharoconjunctivitis
viu: effluviviums
viv: antivivisectionists
vix: vixenishness
viy: caviya
viz: reobjectivization
vkh: sovkhozes
vkt: corvktte
vla: vladislav
vld: bovld
vle: snavvle
vli: livlihood
vll: vvll
vlo: pavlovian
vls: vlsi
vlt: cooghneiorvlt
vly: capacitativly
vma: tradevman
vmi: vmintegral
vms: vmsize
vna: czarevnas
vni: chinovnik
voa: voar
vob: flavobacterium
voc: nonirrevocableness
vod: clavodeltoideus
voe: ovoelliptic
vof: ovoflavin
vog: gingivoglossitis
voi: subjectivoidealistic
vok: unprovokedness
vol: counterrevolutionaries
vom: servomechanically
von: slavonization
voo: voodooistic
vop: flavopurpurin
voq: provoquant
vor: noncarnivorousness
vos: nervosanguineous
vot: nondevotionally
vou: nonmischievousness
vov: ovoviviparousness
vow: unavowableness
vox: sonovoxes
voy: voyeuristically
voz: izvozchik
vpr: sovprene
vra: maneuvrability
vrb: vrbaite
vre: manoeuvreing
vri: manoeuvring
vro: chevronelly
vry: promissvry
vsb: solvsbergite
vsh: avshar
vsk: lobachevskian
vss: savssat
vta: mesivta
vts: berkovtsi
vuc: vucoms
vud: oxhuvud
vue: bellevue
vug: vuggy
vui: prevuing
vul: electroconvulsive
vum: collectivum
vun: avunculate
vur: lithophotogravure
vus: hircocervus
vut: kevutzoth
vuv: clavuvi
vva: galvvanoscopy
vve: flivvers
vvi: improvvisatore
vvl: snavvle
vvy: chivvying
vws: devwsor
vya: avyayibhava
vyb: ivyberries
vye: livyers
vyf: ivyflower
vyh: heavyheartedness
vyi: unenvyingly
vyl: ivylike
vyn: ethchlorvynol
vyr: vyrnwy
vys: heavyset
vyu: gavyuti
vyw: heavyweights
vyy: cavyyard
vzo: shivzoku
vzu: khevzur
waa: deurwaarder
wab: disallowableness
wac: wachenheimer
wad: twaddlemonger
wae: waenesses
waf: wafermaking
wag: unswaggeringly
wah: wahlenbergia
wai: tidewaitership
waj: wajang
wak: unawakableness
wal: twalpennyworth
wam: catawamptiously
wan: volkerwanderung
wap: wappenschawing
war: unstraightforwardness
was: neowashingtonia
wat: waterloggedness
wau: caterwauling
wav: unwaveringly
waw: gimbawawed
wax: waxchandlery
way: catercornerways
waz: swaziland
wba: screwbarrel
wbe: strawberrylike
wbi: sparrowbill
wbl: snowblower
wbo: shadowboxing
wbr: shallowbrained
wbu: snowbushes
wbw: sawbwa
wby: blowbys
wca: cowcatchers
wce: dowcet
wch: flowcharting
wci: sparrowcide
wcl: dewclawed
wco: flowcontrol
wcr: fellowcraft
wcu: hawcuaite
wda: hallowday
wde: chowderheadedness
wdi: overcrowding
wdl: bowdlerizations
wdn: overlewdness
wdo: snowdonian
wdr: screwdrivers
wds: overcrowds
wdu: sawdustlike
wdw: crowdweed
wdy: rowdyishness
wea: weatherproofness
web: spiderwebbing
wec: wecche
wed: swedenborgianism
wee: sweetheartedness
wef: underweft
weg: glaswegian
weh: landwehr
wei: counterweighing
wej: wejack
wek: wekeen
wel: weltanschauungen
wem: wemodness
wen: schwendenerian
weo: laweour
wep: underswept
wer: snailfishessnailflower
wes: westnorthwestwardly
wet: metahewettite
wev: however
wew: wewenoc
wey: deweylite
wez: wanyamwezi
wfa: newfangledness
wfe: pewfellow
wff: howffs
wfi: handsawfishes
wfl: squawflower
wfo: newfoundlander
wfr: bowfront
wfs: howfs
wfu: oversorrowfulness
wga: clewgarnet
wge: askewgee
wgh: plewgh
wgi: lawgivers
wgl: gallowglass
wgo: slowgoing
wgr: shadowgraphist
wgu: blowguns
wha: ablewhackets
whe: hollowheartedness
whf: whf
whi: unwhimsicalness
who: wholeheartedness
whr: kwhr
whs: whsle
whu: whuttering
why: somewhy
wia: krakowiak
wib: twibilled
wic: undersheriffwick
wid: grasswidowhood
wie: wieldableness
wif: housewifeliness
wig: bigwiggedness
wii: wiikite
wik: wikstroemia
wil: williamsoniaceae
wim: swimmingness
win: intertwinements
wip: sideswipers
wir: overswirling
wis: countercurrentwise
wit: uninterferedwith
wiv: puddingwives
wiw: midewiwin
wix: twixtbrain
wiy: maulawiyah
wiz: wizenedness
wjc: wjc
wjo: plowjogger
wju: showjumping
wka: bowkail
wkb: hawkbills
wke: joukerypawkery
wkh: gawkhammer
wki: gawkishness
wkl: hawklike
wkm: hawkmoths
wkn: yellowknife
wkr: pawkrie
wks: nighthawks
wkw: unawkwardness
wky: squawky
wla: trawlability
wlb: trawlboat
wld: bowlderhead
wle: disacknowledgements
wlf: bowlfuls
wlg: owlglass
wlh: owlhead
wli: overfellowlike
wll: unfowllike
wlm: bowlmaker
wln: trawlnet
wlo: wlonkhede
wlp: scowlproof
wlr: yowlring
wls: crawlspace
wlt: sowlth
wlu: adawlut
wlw: crawlways
wly: overfellowly
wma: unshowmanlike
wmb: awmbrie
wme: overshadowment
wmi: sawmilling
wmk: wmk
wmm: shrewmmice
wmo: snowmobilers
wms: shawms
wna: takedownable
wnb: pawnbrokerage
wnc: crowncapping
wnd: daffadowndillies
wne: interownership
wnf: downfalling
wng: downgrading
wnh: downheartedness
wni: nonplantowning
wnl: downloadable
wnm: discrownment
wnn: fullgrownness
wno: knownothingism
wnp: drownproofing
wnr: downrightness
wns: stuffgownsman
wnt: downtroddenness
wnu: grownups
wnw: downwardness
wny: mulligatawny
woa: woadwaxen
wob: collywobbles
woc: jabberwockian
wod: waywodeship
woe: woebegoneness
wof: showoffishness
wog: hornswoggling
woh: twohandedness
woi: woidre
wok: reawoken
wol: phosphowolframic
wom: draughtswomanship
won: wondermongering
woo: woodenheadedness
wop: twopences
wor: counterbreastwork
wos: twoscore
wot: unwotting
wou: unwoundableness
wov: interwovenly
wow: powwowing
woy: woyaway
wpa: shallowpated
wpe: pericowperitis
wph: mellowphone
wpi: swallowpipe
wpl: snowplowing
wpm: wpm
wpo: viewpoints
wpr: screwpropeller
wps: stowps
wpu: cowpunchers
wpy: jowpy
wqu: cowquake
wra: unwrathfulness
wrd: keywrd
wre: interwreathing
wri: photoplaywright
wrn: wrnt
wro: wrongheartedness
wru: yellowrump
wry: nonoutlawry
wsa: browsability
wsb: shrewsbury
wsc: newscasters
wsd: newsdealers
wse: athwarthawse
wsf: bellowsful
wsg: newsgirls
wsh: schoolfellowship
wsi: overbrowsing
wsk: malinowskite
wsl: newslessness
wsm: bellowsmaking
wsn: gallowsness
wso: dawsoniaceous
wsp: newspaperwoman
wsr: newsreader
wss: newsstands
wst: bowstringing
wsu: lawsuiting
wsv: newsvendor
wsw: newsworthiness
wsy: sprowsy
wta: swallowtailed
wtc: owtchah
wte: pewterwort
wth: thoroughgrowth
wti: bartholomewtide
wto: sparrowtongue
wtr: harrowtry
wts: dawts
wtu: blowtubes
wtw: jawtwister
wty: bawty
wuc: wuchereria
wud: redwud
wuf: wuff
wug: wuggishness
wul: wulfenite
wum: archmugwump
wun: wunderkinder
wup: followup
wur: curliewurlie
wus: tamanowus
wut: mishikhwutmetunne
wuz: wuzzling
wve: dowve
wvi: lowville
wwa: strawwalker
wwe: rainbowweed
wwh: skewwhiff
wwi: slowwittedly
wwo: sparrowwort
wwr: interwwrought
wya: chipewyan
wyb: twyblade
wyc: wycliffian
wyd: cywydd
wye: unlawyerlike
wyh: owyheeite
wyk: wykehamical
wyl: wyliecoat
wym: wymote
wyn: wynkernel
wyo: wyomingite
wyp: wype
wyr: morthwyrtha
wys: wyson
wyt: swythe
wyv: wyverns
wze: blowzed
wzi: blowziness
wzl: frowzled
wzy: blowzy
xab: nontaxableness
xac: hexachlorocyclohexane
xad: cyclohexadienyl
xae: autotoxaemia
xaf: hexafluoride
xag: counterexaggeration
xah: hexahydroxycyclohexane
xai: allantoxaidin
xak: hexakistetrahedron
xal: benzofuroquinoxaline
xam: hexamethylenetetramine
xan: hexahydroxycyclohexane
xap: hexapetaloideous
xar: spondylexarthrosis
xas: exasperatingly
xat: antiannexationist
xau: exauthorizeexc
xav: hexavalent
xax: synaxaxaria
xaz: benzophenoxazine
xba: buxbaumiaceae
xbe: boxberries
xbi: flaxbird
xbl: mixblood
xbo: fauxbourdon
xbr: axbreaker
xbu: roxburghiaceae
xby: bixbyite
xca: excandescence
xce: unexceptionableness
xch: nonexchangeability
xci: hyperexcitableness
xcl: semiexclusiveness
xco: counterexcommunication
xcr: excrementitiousness
xct: xctl
xcu: hyperexcursiveness
xcy: excystation
xda: rixdaler
xde: sexdecillions
xdi: benzdioxdiazine
xdr: flaxdrop
xea: tylotoxeate
xeb: axebreaker
xec: dishexecontahedroid
xed: postmyxedematous
xee: hoaxee
xeg: epexegetically
xel: duxelles
xem: nonexemplification
xen: xenomorphically
xeo: praxeological
xeq: exequatur
xer: antixerophthalmic
xes: laryngopharynxes
xet: bradyauxetically
xeu: exeunt
xey: druxey
xfa: sexfarious
xfe: exfetation
xfi: exfiguration
xfl: exflagellation
xfo: exfodiation
xfu: boxfuls
xga: taxgathering
xgi: fixgig
xgl: foxgloves
xgo: exgorgitation
xgr: fluxgraph
xgu: texguino
xha: inexhaustibleness
xhb: exhbn
xhe: exheredation
xhi: nonexhibitionistic
xhl: soxhlet
xho: nonexhortation
xhu: exhumations
xhy: sixhynde
xia: trachelectomopexia
xib: hyperflexibleness
xic: unlexicographically
xid: peroxidicperoxiding
xie: supergalaxies
xif: complexification
xig: lexigraphically
xih: toxihaemia
xii: toxiinfectious
xil: maxillopremaxillary
xim: approximativeness
xin: desiodothyroxine
xio: nonaxiomatically
xip: alexipharmacon
xir: xiraxara
xis: existentialistically
xit: supercomplexities
xiu: reflexiue
xiv: semireflexiveness
xiw: taxiways
xix: maxixes
xke: boxkeeper
xki: kitkahaxki
xla: oxland
xle: indexlessness
xli: nonsexlinked
xlo: sexlocular
xls: cacomixls
xly: antiorthodoxly
xma: pyroxmangite
xme: perplexment
xmi: axminster
xmo: exmoor
xne: overprolixness
xoa: exoarteritis
xob: myxobacteriaceous
xoc: myxochondrosarcoma
xod: nonloxodromical
xoe: exoerythrocytic
xof: myxofibrosarcoma
xog: paradoxographical
xoh: auxohormone
xoi: occipitoaxoid
xok: hexokinase
xol: reflexologically
xom: endotheliomyxoma
xon: chemotaxonomically
xop: exopterygotism
xor: gastromyxorrhea
xos: hexosemonophosphoric
xot: myxothallophyta
xou: ambosexous
xov: paramyxovirus
xoy: hexoylene
xoz: oxozonides
xpa: overexpansiveness
xpd: expdt
xpe: pseudoexperimentally
xph: oxphony
xpi: inexpiableness
xpl: counterexplanation
xpo: counterexpostulation
xpr: antiexpressionistic
xpt: exptl
xpu: inexpugnableness
xpw: expwy
xpy: expy
xqu: superexquisiteness
xra: sexradiate
xre: oxreim
xri: banxring
xro: fluxroot
xru: exrupeal
xrx: exrx
xsa: exsanguinating
xsc: exscriptural
xse: exsequatur
xsh: clarenceuxship
xsi: exsibilation
xsk: foxskins
xso: exsolution
xsp: exspoliation
xst: exstemporaneous
xsu: inexsuperable
xsw: coxswaining
xta: juxtaterrestrial
xtb: textbookless
xtd: nextdoor
xte: extemporaneousness
xtg: extg
xth: boxthorns
xti: unextinguishableness
xtl: intermixtly
xtm: textman
xtn: nextness
xto: extortionateness
xtr: pseudoambidextrously
xts: ciphertexts
xtu: noncontextually
xty: sixtypenny
xua: hypersexualities
xub: overexuberantness
xuc: exucontian
xud: unexudative
xul: nonexultantly
xum: exumbrellar
xun: exundation
xuo: subflexuously
xup: exuperable
xur: superluxuriousness
xus: ganglioplexus
xuv: exuviability
xvi: knoxvillite
xwa: coxwaining
xwe: flaxwench
xwi: flaxwife
xwo: waxworking
xxi: xxiii
xxo: exxon
xxv: xxv
xxx: xxx
xya: hydroxyanthraquinone
xyb: hydroxybutyricacid
xyc: hydroxydesoxycorticosterone
xyd: hydroxydehydrocorticosterone
xye: desoxyephedrine
xyf: methoxyflurane
xyg: hyperoxygenating
xyh: carboxyhemoglobin
xyi: oxyiodide
xyk: hydroxyketone
xyl: formaldehydesulphoxylate
xym: dimethoxymethane
xyn: azoxynaphthalene
xyo: oxyosphresia
xyp: benzoxyphenanthrene
xyq: oxyquinaseptol
xyr: desoxyribonucleoprotein
xys: dihydroxysuccinic
xyt: hydroxytryptamine
xyu: bromodeoxyuridine
xyw: oxywelding
xyz: hydroxyzine
xzo: exzodiacal
yaa: cyaathia
yab: unemployableness
yac: polyacrylonitrile
yad: dacryadenalgia
yae: hypercryaesthesia
yaf: polyaffectioned
yag: unvoyageable
yah: aliyahaliyahs
yai: bolyaian
yaj: yajnavalkya
yak: dyakisdodecahedron
yal: hyalinocrystalline
yam: pseudohyoscyamine
yan: hydroxyanthraquinone
yao: lumbayao
yap: hydroxyapatite
yaq: guayaqui
yar: osphyarthritis
yas: pratiyasamutpada
yat: archaeocyathidae
yau: bradyauxetically
yav: yavapai
yaw: yawmeters
yax: brachyaxis
yay: avyayibhava
yaz: hydroxyazobenzene
yba: sybaritically
ybb: arybballi
ybd: molybdocardialgia
ybe: phenoxybenzamine
ybi: hemibathybian
ybl: pachyblepharon
ybo: busybodyness
ybr: platybrachycephalous
ybu: hydroxybutyricacid
yby: standbybys
yca: brachycatalectic
yce: phosphoglyceraldehyde
ych: philosophicopsychological
yci: triacetyloleandomycin
yck: nyckelharpa
ycl: cyclotrimethylenetrinitramine
ycn: heteropycnosis
yco: hydroxydesoxycorticosterone
ycr: hyperbrachycranial
yct: oryctognostically
ycu: bathycurrent
ycy: hexahydroxycyclohexane
yda: hydatopneumatolytic
ydd: lyddites
yde: hydroxydehydrocorticosterone
ydi: carettochelydidae
ydl: encydlopaedic
ydn: hydnocarpate
ydo: chlamydobacteriaceous
ydr: hydroxydehydrocorticosterone
yds: athodyds
ydu: hydurilate
ydy: polydynamic
yea: yearnfulness
yeb: overeyebrowed
yec: embryectomies
yed: unhackneyedness
yee: mendelyeevite
yef: bukeyef
yeg: eyeglasses
yeh: mashrebeeyeh
yei: overdyeing
yel: polioencephalomyelitis
yem: polyembryonate
yen: lyencephalous
yeo: yeomanette
yep: aryepiglottidean
yer: unprayerfulness
yes: polyesterification
yet: hyetometrographic
yeu: voyeuristically
yev: whyever
yew: eyewitnesses
yex: yex
yey: blearyeyedness
yez: yezidi
yfa: brachyfacial
yfe: playfellowship
yfi: butterflyfishes
yfk: lyfkie
yfl: methoxyflurane
yfo: pussyfooting
yfr: boyfriends
yft: skyfte
yfu: overjoyfulness
yfy: cockneyfying
yfz: styfziekte
yga: interzygapophysial
ygd: pharyngoamygdalitis
yge: arteriococcygeal
ygg: yggdrasil
ygh: huyghenian
ygi: archaeopterygiformes
ygl: polyglottically
ygm: sphygmomanometrically
ygn: brachygnathism
ygo: zygomaticoauricularis
ygr: barothermohygrograph
ygu: bodyguards
ygy: polygynoecial
yha: heavyhandedness
yhe: carboxyhemoglobin
yhi: polyhistorian
yhm: allorrhyhmia
yhn: houyhnhnm
yho: hobbyhorsically
yht: eryhtrism
yhu: bullyhuff
yhw: yhwh
yhy: bathyhyperesthesia
yia: enteromyiasis
yib: avyayibhava
yic: palaeichthyic
yid: epigonichthyidae
yie: unyieldingness
yif: myiferous
yig: tyigh
yii: cecidomyiidous
yik: yikirgaulit
yil: yildun
yim: lechayims
yin: interstratifying
yio: myiodesopsia
yip: yippies
yir: yirmilik
yis: hobbledehoyishness
yit: cephalomyitis
yiz: ichthyization
yja: skyjackers
yka: polykaryocyte
yke: hydroxyketone
ykh: tykhana
yki: bradykinesia
ykj: reykjavik
ykl: kyklopes
ykn: desmopyknosis
yko: glykopectic
yks: bashlyks
ykt: psykters
yku: platykurtosis
yla: diphenylaminechlorarsine
ylb: alkylbenzenesulfonates
ylc: demethylchlortetracycline
yld: phenyldiethanolamine
yle: cyclotrimethylenetrinitramine
ylf: acetylfluoride
ylg: sulfanilylguanidine
ylh: dinitrophenylhydrazine
yli: formaldehydesulphoxylic
ylk: phenylketonuria
yll: hyperpolysyllabically
ylm: trinitrophenylmethylnitramine
yln: trinitrophenylmethylnitramine
ylo: triacetyloleandomycin
ylp: acetylphenylhydrazine
ylq: diphenylquinomethane
ylr: acetylrosaniline
yls: succinylsulphathiazole
ylt: dichlorodiphenyltrichloroethane
ylu: phenylethylmalonylurea
ylv: pennsylvanians
yly: megalosyndactyly
yma: pseudoparenchymatous
ymb: lautenclavicymbal
ymc: ymca
yme: autodepolymerization
ymh: lymhpangiophlebitis
ymi: orchiepididymitis
ymk: gymkhanas
yml: cymlings
ymm: pseudoasymmetrically
ymn: hypsiprymnodontinae
ymo: epididymodeferentectomy
ymp: lymphangioendothelioma
ymr: cymraeg
yms: pseudonyms
ymt: asymtotically
ymu: hyperoxymuriatic
ymy: polymyositis
yna: magnetohydrodynamically
ynb: schynbald
ync: macracanthrorhynchiasis
ynd: blepharosyndesmitis
yne: synenergistically
ynf: synfuels
yng: glossolabiopharyngeal
ynh: brynhild
yni: gastroperiodynia
ynk: synkatathesis
ynl: plynlymmon
ynn: synneurosis
yno: corynocarpaceous
ynp: mynpachtbrief
ynr: synrhabdosome
yns: postsynsacral
ynt: electrosynthetically
ynu: polynucleotidase
ynw: tynwald
ynx: laryngopharynxes
yny: epionynychia
ynz: brynza
yoa: dacryoadenalgia
yob: ichthyobatrachian
yoc: dacryocystoblennorrhea
yod: ichthyodectidae
yoe: hyoepiglottidean
yof: adenoliomyofibroma
yog: electromyographically
yoh: myohemoglobinuria
yoi: platysmamyoides
yoj: yojuane
yok: yokeableness
yol: neuroembryological
yom: prostatomyomectomy
yon: nonembryonically
yoo: kyoodling
yop: pyopneumocholecystitis
yoq: clayoquot
yor: ichthyornithiformes
yos: dictyosiphonaceous
yot: ophthalmomyotomy
you: overjoyousness
yov: pyovesiculosis
yow: laundryowner
yox: polyoxymethylene
yoy: ukiyoye
yoz: diphyozooid
ypa: trypanosomacidal
ype: hyperconscientiousness
yph: phoneticohieroglyphic
ypi: hypidiomorphically
ypl: blepharophryplasty
ypn: autohypnotization
ypo: hypocholesterinemia
ypp: corypphaei
ypr: hypereuryprosopic
yps: hypsidolichocephalism
ypt: microcryptocrystalline
ypu: carcinopolypus
ypw: typw
ypy: chromocollotypy
yqu: oxyquinaseptol
yra: triangulopyramidal
yrb: scelotyrbe
yrc: eupyrchroite
yrd: martyrdoms
yre: regeneratoryregeneratress
yrf: gyrfalcons
yrg: pyrgocephalic
yrh: spectropyrheliometer
yri: desoxyribonucleoprotein
yrl: unzephyrlike
yrm: protectinglyrmal
yrn: sphyrnidae
yro: thyroparathyroidectomize
yrp: syrphians
yrr: polyvinylpyrrolidone
yrs: thyrsiflorous
yrt: stethokyrtograph
yru: phosphoenolpyruvate
yry: benzopyrylium
ysa: heteropolysaccharide
ysb: gettysburg
ysc: blepharodyschroia
yse: selectivitysenescence
ysf: dysfunctioning
ysg: dysgeogenous
ysh: plenipotentiaryship
ysi: anatomicophysiological
ysk: hyperbrachyskelic
ysl: dyslogistically
ysm: plethysmographically
ysn: cardiodysneuria
yso: chrysoaristocracy
ysp: molybdodyspepsia
ysr: dysrhythmia
yss: abyssobenthonic
yst: cholecystenterorrhaphy
ysu: subsultorysubsultus
ysw: flyswatter
ysy: hyperpolysyllabically
ysz: krzysztof
yta: pteridospermaphyta
yte: polytetrafluoroethylene
yth: erythrodegenerative
yti: nonpsychoanalytically
ytl: gytling
ytm: brachytmema
yto: cytospectrophotometry
ytr: proctoelytroplastic
yts: fluyts
ytt: phragmocyttarous
ytu: topsyturviness
ytw: thirtytwomo
yty: brachytypous
yua: yuapin
yub: cayubaban
yuc: yucatecan
yud: ayudante
yue: arroyuelo
yuf: yuft
yug: yugoslavians
yuh: seiyuhonto
yui: yuit
yuk: ahantchuyuk
yul: embryulculci
yum: sarcodictyum
yun: polyunsaturated
yup: wickyups
yuq: yuquillas
yur: bromodeoxyuridine
yus: centrosoyus
yut: gavyuti
yuv: pacouryuva
yuy: ayuyu
yuz: yuzlik
yva: pachyvaginitis
yve: arsyversy
yvi: polyvinylpyrrolidone
yvo: polyvoltine
yvu: pyvuril
ywa: windwaywardly
ywc: ywca
ywd: keywd
ywe: heavyweights
ywh: everywhereness
ywi: communitywide
ywo: threepennyworth
ywr: photoplaywright
ywy: cywydd
yxa: myxadenitis
yxe: postmyxedematous
yxi: autoasphyxiation
yxo: chondromyxosarcoma
yxy: asphyxy
yya: cavyyard
yye: cubbyyew
yyi: sayyids
yyo: snarleyyow
yyu: ayyubid
yza: electrolyzability
yze: electrodialyzer
yzg: wayzgoose
yzi: psychoanalyzing
yzo: myzodendraceous
yzu: coccyzus
yzy: syzygetically
yzz: zyzzogeton
zaa: superbazaar
zab: uncrystallizability
zac: benzacridine
zad: scheherazade
zae: schizaeaceous
zaf: azafran
zag: zigzaggedness
zah: huzzahing
zai: stanzaically
zak: zaklohpakap
zal: benzalphenylhydrazone
zam: phenoxybenzamine
zan: benzantialdoxime
zap: zaphrentidae
zaq: zaqqum
zar: nonhazardousness
zas: extravaganzas
zat: overintellectualization
zau: rhizautoicous
zav: mezzavoce
zaw: arzawa
zax: schizaxon
zay: zayins
zaz: benzazimide
zba: rezbanyite
zbe: razzberries
zbi: benzbitriazole
zbo: swartzbois
zbr: milzbrand
zbu: harzburgite
zca: tezcatzoncatl
zce: neumatizce
zch: witzchoura
zcl: fitzclarence
zcu: tezcucan
zda: mazdakean
zde: yazdegerdian
zdi: benzdioxtriazine
zdo: mazdoor
zdr: nazdrowie
zdu: izdubar
zea: superzealousness
zeb: beelzebubian
zec: czechoslovakians
zed: overintellectualized
zee: exauthorizeexc
zef: prizefighters
zeg: herzegovinian
zeh: prizeholder
zei: cruzeiros
zek: hezekiah
zel: overanalyzely
zem: perfectionizement
zen: alkylbenzenesulfonates
zeo: zeolitization
zep: chlordiazepoxide
zeq: zequin
zer: scheuchzeriaceous
zes: uncompartmentalizes
zet: gazetteership
zeu: zeuctocoelomatic
zev: elzevirian
zew: prizewinners
zey: craizey
zfe: salzfelle
zfl: spitzflute
zga: akazga
zgh: lezghian
zgi: akazgine
zgl: buzzgloak
zgo: wayzgoose
zha: dobzhansky
zhe: alzheimer
zhi: muzhiks
zhk: pirozhki
zhm: zhmud
zhn: brezhnev
zho: manabozho
zhy: benzhydroxamic
zia: pestalozzianism
zib: zinziberaceous
zic: quizzicalness
zid: hydrochlorothiazide
zie: capercailzie
zif: denazification
zig: zigzaggedness
zih: zihar
zii: naziism
zik: zikkurats
zil: zilchviticetum
zim: hydrazimethylene
zin: dinitrophenylhydrazine
zio: trapeziometacarpal
zip: marzipans
ziq: beziques
zir: hydrofluozirconic
zis: spinozistic
zit: cuprodescloizite
ziu: trapeziuses
ziv: oryzivorous
ziw: fezziwig
zix: skeezix
ziz: pyrenopeziza
zji: muzjiks
zka: britzkas
zke: tezkere
zki: tezkirah
zkn: lanzknecht
zko: spitzkop
zkr: blitzkrieging
zky: kosteletzkya
zla: chremzlach
zle: puzzleheadedness
zli: bedazzlingly
zlo: zlotych
zlu: yuzluk
zly: grizzlyman
zma: quizmaster
zme: jazzmen
zmi: khwarazmian
zmo: gizmos
zmu: zmudz
zna: biznagas
zne: ghaznevid
zni: kibbutznik
znk: kwaznku
zno: viznomy
zoa: diazoaminobenzene
zob: benzeneazobenzene
zoc: piezocrystallization
zod: azodicarboxylic
zoe: piezoelectrically
zof: benzofuroquinoxaline
zog: schizogenetically
zoh: diazohydroxide
zoi: azoisobutyronitrile
zok: ozokerite
zol: succinylsulphathiazole
zom: benzomorpholine
zon: benzalphenylhydrazone
zoo: zoologicoarchaeologist
zop: benzophenanthrazine
zoq: orthobenzoquinone
zor: zoroastrianism
zos: benzosulphimide
zot: benzothiodiazole
zou: ornithomyzous
zov: azovernine
zow: zowie
zox: benzoxyphenanthrene
zoy: benzoylglycine
zoz: gazoz
zpa: chutzpadik
zpi: benzpinacone
zpo: bezpopovets
zpy: benzpyrene
zqu: mezquites
zra: mizrach
zre: jezreelite
zro: hezronites
zru: arzrunite
zsa: vammazsa
zsc: nietzscheanism
zsk: britzskas
zsl: vizslas
zta: fuzztail
zte: aztecan
zth: benzthiophen
zti: schiztic
ztl: teponaztli
zto: krzysztof
ztr: benztrioxazine
zub: zubeneschamali
zuc: zucchettos
zud: zudda
zue: venezuelans
zuf: zuffolo
zug: zugtierlaster
zuh: kazuhiro
zui: zenzuic
zuk: buzukia
zul: lazulites
zum: montezuma
zun: yokozunas
zuo: pozzuolanic
zup: zupanate
zur: azurmalachite
zus: pachyrhizus
zut: dashnaktzutiun
zuu: zuurveldt
zuz: mezuzahs
zva: huzvaresh
zvo: rendezvousing
zwa: fizzwater
zwi: zwinglianism
zwo: buzzwords
zya: jizyah
zyb: lazybones
zyc: crazycat
zyd: zydecos
zyg: zygomaticoauricularis
zyh: lazyhood
zyi: dizzyingly
zyl: benzylpenicillin
zym: coenzymatically
zyp: zizyphus
zyr: zyrenian
zys: krzysztof
zyt: zythem
zyv: zyzzyvas
zyw: crazyweed
zyz: zyzzogeton
zza: belshazzaresque
zzb: razzberries
zze: mizzenmastman
zzg: buzzgloak
zzi: pestalozzianism
zzl: puzzleheadedness
zzm: razzmatazz
zzo: photomezzotype
zzs: buzzsaw
zzt: fuzztail
zzu: pozzuolanic
zzw: buzzwords
zzy: dizzyingly
